人民币	人民币 ￥
日元	日元 ￥ 💴
日币	日币 ￥
美元	美元 $ 💵 💲
美刀	美刀 $
港元	港元 HK$
港币	港币 HK$
澳门元	澳门元 MOP$
澳门币	澳门币 MOP$
葡币	葡币 MOP$
新加坡元	新加坡元 S$
新加坡币	新加坡币 S$
欧元	欧元 € 💶
英镑	英镑 £ 💷
笑脸	笑脸 😀
露齿笑	露齿笑 😃
哈	哈 😄
哈哈	哈哈 😄
开心	开心 😄
笑	笑 😄 😊
高兴	高兴 😄
憨憨	憨憨 😄
嘻嘻	嘻嘻 😁
嘿嘿	嘿嘿 😁
咧嘴笑	咧嘴笑 😁
傻笑	傻笑 😆
眯眼笑	眯眼笑 😆
笑死	笑死 😆
好耶	好耶 😆
笑晕	笑晕 😆
汗	汗 😅 😰 😓
冷汗	冷汗 😅 😰 😓
冒汗	冒汗 😅 😰 😓
无语	无语 😅 😰 😓
尴尬	尴尬 😅 😰 😓
苦笑	苦笑 😅
大笑	大笑 🤣 😂
笑哭	笑哭 🤣 😂
笑哭了	笑哭了 🤣 😂
笑出眼泪	笑出眼泪 🤣 😂
打滚	打滚 🤣
打滚儿	打滚儿 🤣
笑得打滚	笑得打滚 🤣
笑得打滚儿	笑得打滚儿 🤣
笑得满地打滚	笑得满地打滚 🤣
笑得满地打滚儿	笑得满地打滚儿 🤣
呵呵	呵呵 🙂 🙃
倒脸	倒脸 🙃
颠倒	颠倒 🙃
颠倒的脸	颠倒的脸 🙃
消失	消失 🫠 🫥
溶解	溶解 🫠
融化	融化 🫠
眨眼	眨眼 😉
媚眼	媚眼 😉
抛媚眼	抛媚眼 😉
微笑	微笑 😊
脸红	脸红 😊 😳
光环	光环 😇
微笑天使	微笑天使 😇
喜笑颜开	喜笑颜开 🥰
爱心环绕	爱心环绕 🥰
爱慕	爱慕 🥰
迷恋	迷恋 🥰
陷入爱河	陷入爱河 🥰
坠入爱河	坠入爱河 🥰
幸福	幸福 🥰
喜欢	喜欢 😍 ♥️
花痴	花痴 😍
崇拜	崇拜 🤩
好崇拜	好崇拜 🤩
好崇拜哦	好崇拜哦 🤩
星星眼	星星眼 🤩
眼冒星星	眼冒星星 🤩
亲亲	亲亲 😘
飞吻	飞吻 😘
噘嘴	噘嘴 😗 🙎‍♂️ 🙎‍♀️
羞涩亲亲	羞涩亲亲 😚
微笑亲亲	微笑亲亲 😙
含泪的笑脸	含泪的笑脸 🥲
含泪笑脸	含泪笑脸 🥲
欣慰	欣慰 🥲
好吃	好吃 😋
津津有味	津津有味 😋
美味	美味 😋
吐舌	吐舌 😛 😜 😝
吐舌头	吐舌头 😛 😜 😝
略略略	略略略 😛 😜 😝
单眼吐舌	单眼吐舌 😜
调皮	调皮 😜
傻瓜	傻瓜 🤪
傻瓜脸	傻瓜脸 🤪
眯眼	眯眼 😝
眯眼吐舌	眯眼吐舌 😝
开玩笑	开玩笑 😝
嘲笑	嘲笑 😝
发财	发财 🤑
财迷	财迷 🤑
拜金	拜金 🤑
见钱眼开	见钱眼开 🤑
钱眼	钱眼 🤑
钱眼儿	钱眼儿 🤑
抱抱	抱抱 🤗 🫂
拥抱	拥抱 🤗 🫂
捂嘴	捂嘴 🤭 🙊
捂嘴巴	捂嘴巴 🤭 🙊
捂上嘴巴	捂上嘴巴 🤭 🙊
捂住嘴巴	捂住嘴巴 🤭 🙊
捂着嘴巴	捂着嘴巴 🤭 🙊
捂嘴笑	捂嘴笑 🤭
捂着嘴笑	捂着嘴笑 🤭
好笑	好笑 🤭
不敢相信	不敢相信 🫢
unbelievable	unbelievable 🫢
偷看	偷看 🫣
偷偷看	偷偷看 🫣
偷瞧	偷瞧 🫣
偷偷瞧	偷偷瞧 🫣
单眼偷看	单眼偷看 🫣
不敢看	不敢看 🫣
我不敢看	我不敢看 🫣
画面太美我不敢看	画面太美我不敢看 🫣
那画面太美我不敢看	那画面太美我不敢看 🫣
嘘	嘘 🤫
安静	安静 🤫
安静的脸	安静的脸 🤫
小声	小声 🤫
小点声	小点声 🤫
小点儿声	小点儿声 🤫
小声点	小声点 🤫
小声点儿	小声点儿 🤫
别说话	别说话 🤫
深思的脸	深思的脸 🤔
深思	深思 🤔
思考	思考 🤔
奇怪	奇怪 🤔
奇怪了	奇怪了 🤔
想一想	想一想 🤔
想想	想想 🤔
我想想	我想想 🤔
我再想想	我再想想 🤔
容我三思	容我三思 🤔
呃	呃 🤔
疑问	疑问 🤔
可能	可能 🤔
不理解	不理解 🤔
不明白	不明白 🤔
敬礼	敬礼 🫡
致敬	致敬 🫡
尊敬	尊敬 🫡
尊重	尊重 🫡
瑞思拜	瑞思拜 🫡
respect	respect 🫡
闭嘴	闭嘴 🤐
秘密	秘密 🤐 ㊙️
保密	保密 🤐
守密	守密 🤐
不说	不说 🤐 🙊
不能说	不能说 🤐
不要说	不要说 🤐
拉上拉链	拉上拉链 🤐
封口	封口 🤐
禁言	禁言 🤐
挑眉	挑眉 🤨
眉毛上挑	眉毛上挑 🤨
眉毛上挑的脸	眉毛上挑的脸 🤨
平静	平静 😐
面无表情	面无表情 😑
没有嘴	没有嘴 😶
没有嘴巴	没有嘴巴 😶
沉默	沉默 😶
隐形	隐形 🫥
隐藏	隐藏 🫥
虚线脸	虚线脸 🫥
虚线轮廓	虚线轮廓 🫥
云中	云中 😶‍🌫️
云中的脸	云中的脸 😶‍🌫️
得意	得意 😏
得意地笑	得意地笑 😏
郁闷	郁闷 😒
鄙视	鄙视 😒
白眼	白眼 🙄
白眼儿	白眼儿 🙄
翻白眼	翻白眼 🙄
翻白眼儿	翻白眼儿 🙄
咬牙切齿	咬牙切齿 😬
龇牙咧嘴	龇牙咧嘴 😬
龇牙	龇牙 😬
咬牙	咬牙 😬
呼气	呼气 😮‍💨 🫁
叹气	叹气 😮‍💨
唉	唉 😮‍💨
无奈	无奈 😮‍💨
长鼻子	长鼻子 🤥
长鼻	长鼻 🤥
匹诺曹	匹诺曹 🤥
说谎	说谎 🤥
撒谎	撒谎 🤥
乱讲	乱讲 🤥
胡说	胡说 🤥
骗子	骗子 🤥
骗人	骗人 🤥
骗人布	骗人布 🤥
乌索普	乌索普 🤥
摇头	摇头 🫨
晃脑	晃脑 🫨
摇头晃脑	摇头晃脑 🫨
颤抖的脸	颤抖的脸 🫨
猛摇头	猛摇头 🫨
如释重负	如释重负 😌
松口气	松口气 😌
松了口气	松了口气 😌
松了一口气	松了一口气 😌
释然	释然 😌
低头忧伤	低头忧伤 😔
心事重重	心事重重 😔
忧虑	忧虑 😔
忧伤	忧伤 😔
困	困 😪 🥱
困困	困困 😪
困了	困了 😪 🥱
困倦	困倦 😪 🥱
困乏	困乏 😪
瞌睡	瞌睡 😪
打瞌睡	打瞌睡 😪
口水	口水 🤤
流口水	流口水 🤤
垂涎三尺	垂涎三尺 🤤
睡觉	睡觉 😴 💤 🛌
睡着	睡着 😴 💤
睡着了	睡着了 😴 💤
睡了	睡了 😴 💤
睡眠	睡眠 😴 💤
口罩	口罩 😷
戴口罩	戴口罩 😷
感冒	感冒 😷 🤧
生病	生病 😷
体温计	体温计 🤒
量体温	量体温 🤒
发烧	发烧 🤒
受伤	受伤 🤕 ❤️‍🩹
负伤	负伤 🤕
绷带	绷带 🤕
缠绷带	缠绷带 🤕
缠满绷带	缠满绷带 🤕
恶心	恶心 🤢
想吐	想吐 🤢
反胃	反胃 🤢
吐	吐 🤮
吐了	吐了 🤮
呕吐	呕吐 🤮
吐出来	吐出来 🤮
喷嚏	喷嚏 🤧
打喷嚏	打喷嚏 🤧
鼻涕	鼻涕 🤧
擤鼻涕	擤鼻涕 🤧
擤鼻子	擤鼻子 🤧
鼻炎	鼻炎 🤧
热	热 🥵
很热	很热 🥵
好热	好热 🥵
发热	发热 🥵
脸发烧	脸发烧 🥵
辣	辣 🥵
辣死	辣死 🥵
辣死了	辣死了 🥵
超辣	超辣 🥵
超级辣	超级辣 🥵
热死	热死 🥵
热死了	热死了 🥵
爆辣	爆辣 🥵
冷	冷 🥶
很冷	很冷 🥶
冰冷	冰冷 🥶
好冷	好冷 🥶
冷冰冰	冷冰冰 🥶
冷脸	冷脸 🥶
冻僵	冻僵 🥶
冻僵了	冻僵了 🥶
满面寒霜	满面寒霜 🥶
微醺	微醺 🥴
醉了	醉了 🥴
喝醉	喝醉 🥴
喝醉了	喝醉了 🥴
喝多	喝多 🥴
喝多了	喝多了 🥴
晕	晕 😵 😵‍💫
晕了	晕了 😵 😵‍💫
我晕	我晕 😵 😵‍💫
头晕	头晕 😵 😵‍💫
晕头	晕头 😵 😵‍💫
头晕目眩	头晕目眩 😵 😵‍💫 💫
晕头转向	晕头转向 😵 😵‍💫
头晕眼花	头晕眼花 😵 😵‍💫
爆炸头	爆炸头 🤯
爆炸脑	爆炸脑 🤯
头爆炸	头爆炸 🤯
脑子爆炸	脑子爆炸 🤯
脑袋爆炸	脑袋爆炸 🤯
脑爆炸	脑爆炸 🤯
大脑爆炸	大脑爆炸 🤯
爆头	爆头 🤯
牛仔	牛仔 🤠
牛仔帽	牛仔帽 🤠
牛仔帽脸	牛仔帽脸 🤠
派对	派对 🥳 🎉
派对脸	派对脸 🥳
庆祝	庆祝 🥳 🎉
开趴	开趴 🥳
开淫趴	开淫趴 🥳
开银趴	开银趴 🥳
party	party 🥳
开party	开party 🥳
伪装	伪装 🥸
伪装的脸	伪装的脸 🥸
隐瞒身份	隐瞒身份 🥸
太阳镜	太阳镜 😎 🕶
墨镜	墨镜 😎 🕶
墨镜笑脸	墨镜笑脸 😎
自信	自信 😎
书呆子	书呆子 🤓
书呆子脸	书呆子脸 🤓
单片眼镜	单片眼镜 🧐
带单片眼镜的脸	带单片眼镜的脸 🧐
探究	探究 🧐
研究	研究 🧐
不懂	不懂 😕
困惑	困惑 😕
困扰	困扰 😕
疑惑	疑惑 😕
撇嘴	撇嘴 🫤
不确定	不确定 🫤
担心	担心 😟
担忧	担忧 😟
不开心	不开心 🙁
不高兴	不高兴 🙁
不满	不满 🙁
微微不满	微微不满 🙁
心情不好	心情不好 🙁
不悦	不悦 🙁
一脸不悦	一脸不悦 🙁
吃惊	吃惊 😮 😯 😲 😦 😧
惊讶	惊讶 😮 😯 😲 😦 😧
哦	哦 😮
好奇	好奇 😯
震惊	震惊 😲 😦 😧
啊	啊 😲 😦 😧
害羞	害羞 😳
羞涩	羞涩 😳
愣住	愣住 😳
可怜	可怜 🥺
可怜兮兮	可怜兮兮 🥺
好嘛	好嘛 🥺
求你了	求你了 🥺 🙏
求求你	求求你 🥺 🙏
求求你了	求求你了 🥺 🙏
忍住泪水	忍住泪水 🥹
强忍泪水	强忍泪水 🥹
要哭了	要哭了 🥹
含泪	含泪 🥹
目瞪口呆	目瞪口呆 😦
怕	怕 😨 😱
可怕	可怕 😨 😱
害怕	害怕 😨 😱
恐惧	恐惧 😨 😱
焦虑	焦虑 😰 😩
冒汗焦虑	冒汗焦虑 😰
紧张	紧张 😰
失望但如释重负	失望但如释重负 😥
难过但释然	难过但释然 😥
哭	哭 😢 😭
哭了	哭了 😢 😭
哭泣	哭泣 😢 😭
流泪	流泪 😢 😭
流眼泪	流眼泪 😢 😭
大哭	大哭 😭
放声大哭	放声大哭 😭
痛哭	痛哭 😭
吓死	吓死 😱
吓死了	吓死了 😱
吓人	吓人 😱
尖叫	尖叫 😱
恐怖	恐怖 😱
恐惧尖叫	恐惧尖叫 😱
惊声尖叫	惊声尖叫 😱
焦头烂额	焦头烂额 😖
纠结	纠结 😖
忍耐	忍耐 😣
失望	失望 😞
难过	难过 😞
倒霉	倒霉 😓
疲倦	疲倦 😩
疲劳	疲劳 😩
疲惫	疲惫 😩
焦躁	焦躁 😩
抓狂	抓狂 😫
呵欠	呵欠 🥱
哈欠	哈欠 🥱
打哈欠	打哈欠 🥱
打呵欠	打呵欠 🥱
傲慢	傲慢 😤
趾高气昂	趾高气昂 😤
鼻子冒气	鼻子冒气 😤
怒	怒 😡 😠 💢
愤怒	愤怒 😡 😠 💢
生气	生气 😡 😠 💢
发火	发火 😡
发飙	发飙 😡
怒火中烧	怒火中烧 😡
烦死	烦死 😡
烦死人	烦死人 😡
烦死了	烦死了 😡
烦死啦	烦死啦 😡
angry	angry 😡 😠 💢
微怒	微怒 😠
骂人	骂人 🤬
咒骂	咒骂 🤬
脏话	脏话 🤬
说脏话	说脏话 🤬
你妈死了	你妈死了 🤬
NMSL	NMSL 🤬
肏你妈	肏你妈 🤬
操你妈	操你妈 🤬
傻逼	傻逼 🤬
出口成脏	出口成脏 🤬
恶魔	恶魔 😈 👿
魔鬼	魔鬼 😈 👿
微笑恶魔	微笑恶魔 😈
恶魔微笑	恶魔微笑 😈
微笑的恶魔	微笑的恶魔 😈
生气恶魔	生气恶魔 👿
恶魔生气	恶魔生气 👿
生气的恶魔	生气的恶魔 👿
头骨	头骨 💀 ☠️
骷髅	骷髅 💀 ☠️
骷髅头	骷髅头 💀 ☠️
死亡	死亡 💀 ☠️
屎	屎 💩
拉屎	拉屎 💩
大便	大便 💩
拉大便	拉大便 💩
便便	便便 💩
拉便便	拉便便 💩
粑粑	粑粑 💩
拉粑粑	拉粑粑 💩
小丑	小丑 🤡
小丑脸	小丑脸 🤡
怪物	怪物 👹
妖怪	妖怪 👺
鬼	鬼 👻
鬼魂	鬼魂 👻
幽灵	幽灵 👻
外星人	外星人 👽
怪兽	怪兽 👾
异形怪兽	异形怪兽 👾
外星怪物	外星怪物 👾
机器人	机器人 🤖
开心猫	开心猫 😺
开心的猫	开心的猫 😺
开心猫脸	开心猫脸 😺
微笑猫	微笑猫 😸
微笑的猫	微笑的猫 😸
微笑猫脸	微笑猫脸 😸
笑中带泪	笑中带泪 😹
喜极而泣	喜极而泣 😹
笑出眼泪的猫	笑出眼泪的猫 😹
花痴猫	花痴猫 😻
花痴的猫	花痴的猫 😻
花痴猫脸	花痴猫脸 😻
得意猫	得意猫 😼
得意的猫	得意的猫 😼
得意猫脸	得意猫脸 😼
亲亲猫	亲亲猫 😽
亲亲的猫	亲亲的猫 😽
亲亲猫脸	亲亲猫脸 😽
恐惧猫	恐惧猫 🙀
恐惧的猫	恐惧的猫 🙀
恐惧猫脸	恐惧猫脸 🙀
害怕猫	害怕猫 🙀
害怕的猫	害怕的猫 🙀
害怕猫脸	害怕猫脸 🙀
哭泣猫	哭泣猫 😿
哭泣的猫	哭泣的猫 😿
哭泣猫脸	哭泣猫脸 😿
生气猫	生气猫 😾
生气的猫	生气的猫 😾
生气猫脸	生气猫脸 😾
噘嘴猫	噘嘴猫 😾
噘嘴的猫	噘嘴的猫 😾
噘嘴猫脸	噘嘴猫脸 😾
非礼勿视	非礼勿视 🙈
不看	不看 🙈
蒙眼	蒙眼 🙈
蒙眼睛	蒙眼睛 🙈
蒙住眼睛	蒙住眼睛 🙈
我不看	我不看 🙈
非礼勿听	非礼勿听 🙉
不听	不听 🙉
堵耳	堵耳 🙉
堵耳朵	堵耳朵 🙉
堵上耳朵	堵上耳朵 🙉
堵住耳朵	堵住耳朵 🙉
堵着耳朵	堵着耳朵 🙉
捂耳	捂耳 🙉
捂耳朵	捂耳朵 🙉
捂上耳朵	捂上耳朵 🙉
捂住耳朵	捂住耳朵 🙉
捂着耳朵	捂着耳朵 🙉
我不听	我不听 🙉
非礼勿言	非礼勿言 🙊
情书	情书 💌
一箭穿心	一箭穿心 💘
丘比特	丘比特 💘
心中箭了	心中箭了 💘
爱的礼物	爱的礼物 💝
系有缎带的心	系有缎带的心 💝
饰以丝带的心	饰以丝带的心 💝
送你一颗心	送你一颗心 💝
闪亮的心	闪亮的心 💖
爱心	爱心 💖 ♥️
膨胀的心	膨胀的心 💗
膨胀的爱心	膨胀的爱心 💗
搏动的心	搏动的心 💗
心动	心动 💓
心跳	心跳 💓
爱情	爱情 💓 💕 👩‍❤️‍👨
love	love 💓 💕 👩‍❤️‍👨 ♥️
旋转的心	旋转的心 💞
舞动的心	舞动的心 💞
心连心	心连心 💞
两颗心	两颗心 💕
粉色的心	粉色的心 💕 🩷
心型装饰	心型装饰 💟
心叹号	心叹号 ❣️
伤心	伤心 💔
心碎	心碎 💔
失恋	失恋 💔
火上之心	火上之心 ❤️‍🔥
心火	心火 ❤️‍🔥
燃烧的心	燃烧的心 ❤️‍🔥
心在燃烧	心在燃烧 ❤️‍🔥
心在着火	心在着火 ❤️‍🔥
爱火	爱火 ❤️‍🔥
修复受伤的心灵	修复受伤的心灵 ❤️‍🩹
治愈的心	治愈的心 ❤️‍🩹
受伤的心	受伤的心 ❤️‍🩹
受伤的心灵	受伤的心灵 ❤️‍🩹
心伤	心伤 ❤️‍🩹
粉心	粉心 🩷
粉色心	粉色心 🩷
粉红心	粉红心 🩷
橙心	橙心 🧡
橙色心	橙色心 🧡
橙色的心	橙色的心 🧡
橘心	橘心 🧡
橘色心	橘色心 🧡
橘色的心	橘色的心 🧡
黄心	黄心 💛
黄色心	黄色心 💛
黄色的心	黄色的心 💛
绿心	绿心 💚
绿色心	绿色心 💚
绿色的心	绿色的心 💚
蓝心	蓝心 💙 🩵
蓝色心	蓝色心 💙 🩵
蓝色的心	蓝色的心 💙 🩵
淡蓝心	淡蓝心 🩵
淡蓝色心	淡蓝色心 🩵
淡蓝色的心	淡蓝色的心 🩵
紫心	紫心 💜
紫色心	紫色心 💜
紫色的心	紫色的心 💜
棕心	棕心 🤎
棕色心	棕色心 🤎
棕色的心	棕色的心 🤎
黑心	黑心 🖤
黑色心	黑色心 🖤
黑色的心	黑色的心 🖤
灰心	灰心 🩶
灰色心	灰色心 🩶
灰色的心	灰色的心 🩶
白心	白心 🤍
白色心	白色心 🤍
白色的心	白色的心 🤍
亲	亲 💋
吻	吻 💋
亲吻	亲吻 💋
亲嘴	亲嘴 💋
唇	唇 💋 👄
唇印	唇印 💋
红唇	红唇 💋 👄
吻痕	吻痕 💋
kiss	kiss 💋
么么	么么 💋
么么哒	么么哒 💋
一百	一百 💯
一百分	一百分 💯
满分	满分 💯
火大	火大 💢
青筋	青筋 💢
生气符号	生气符号 💢
爆炸	爆炸 💥
水珠	水珠 💦 💧
水滴	水滴 💦 💧
阵风	阵风 💨
坑	坑 🕳
洞	洞 🕳
下水道	下水道 🕳
对话气泡	对话气泡 💬 🗨 🗯
对话框	对话框 💬 🗨 🗯 💭
证人	证人 👁️‍🗨️
我是证人	我是证人 👁️‍🗨️
朝左的对话气泡	朝左的对话气泡 🗨
愤怒对话气泡	愤怒对话气泡 🗯
愤怒对话框	愤怒对话框 🗯
思考气泡	思考气泡 💭
内心活动气泡	内心活动气泡 💭
睡眠符号	睡眠符号 💤
ZZZ	ZZZ 💤
挥手	挥手 👋
摆手	摆手 👋
你好	你好 👋
再见	再见 👋
拜拜	拜拜 👋
手背	手背 🤚
手指张开	手指张开 🖐
手指张开的手	手指张开的手 🖐
举起的手	举起的手 ✋
手掌	手掌 ✋
击掌	击掌 ✋
手	手 ✋
瓦肯举手礼	瓦肯举手礼 🖖
瓦肯	瓦肯 🖖
斯波克	斯波克 🖖
星际迷航	星际迷航 🖖
右手	右手 🫱 🫸
向右的手	向右的手 🫱
向右伸的手	向右伸的手 🫱
朝右	朝右 🫱
左手	左手 🫲 🫷
向左的手	向左的手 🫲
向左伸的手	向左伸的手 🫲
朝左	朝左 🫲
手掌朝下	手掌朝下 🫳
掌心朝下	掌心朝下 🫳
朝下	朝下 🫳
放手	放手 🫳
手掌朝上	手掌朝上 🫴
掌心朝上	掌心朝上 🫴
朝上	朝上 🫴
伸手	伸手 🫴
抬起	抬起 🫴
左推	左推 🫷
向左推	向左推 🫷
推手	推手 🫷 🫸
向左推手	向左推手 🫷
向左推的手	向左推的手 🫷
右推	右推 🫸
向右推	向右推 🫸
向右推手	向右推手 🫸
向右推的手	向右推的手 🫸
OK	OK 👌 🙆‍♂️ 🙆‍♀️ 🆗
好	好 👌 👍 🙆‍♂️ 🙆‍♀️
好的	好的 👌 🙆‍♂️ 🙆‍♀️
好哒	好哒 👌
没问题	没问题 👌
手指捏和	手指捏和 🤌
捏合	捏合 🤌
兰花指	兰花指 🤌
捏手指	捏手指 🤌
手指	手指 🤌
一点	一点 🤏 🕐
一点儿	一点儿 🤏
一点点	一点点 🤏
少量	少量 🤏
少许	少许 🤏
和平手势	和平手势 ✌️
耶	耶 ✌️
哦耶	哦耶 ✌️
成功	成功 ✌️
胜利	胜利 ✌️
赢了	赢了 ✌️
剪刀手	剪刀手 ✌️
赢啦	赢啦 ✌️
赢咯	赢咯 ✌️
两个	两个 ✌️
第二	第二 ✌️
手指交叉	手指交叉 🤞
交叉的手指	交叉的手指 🤞
食指和拇指交叉的手	食指和拇指交叉的手 🫰
响指	响指 🫰
打响指	打响指 🫰
比心	比心 🫰 🫶
比心手势	比心手势 🫰 🫶
爱你手势	爱你手势 🤟
爱你的手势	爱你的手势 🤟
爱你	爱你 🤟
我爱你	我爱你 🤟
摇滚	摇滚 🤘
摇滚手势	摇滚手势 🤘
金属礼	金属礼 🤘
打电话	打电话 🤙
回电话	回电话 🤙
打给我	打给我 🤙
给我打电话	给我打电话 🤙
打电话给我	打电话给我 🤙
反手食指向左指	反手食指向左指 👈
向左指	向左指 👈
向左	向左 👈
往左	往左 👈
往左指	往左指 👈
左面	左面 👈
左边	左边 👈
反手食指向右指	反手食指向右指 👉
向右指	向右指 👉
向右	向右 👉
往右	往右 👉
往右指	往右指 👉
右面	右面 👉
右边	右边 👉
反手食指向上指	反手食指向上指 👆
向上指	向上指 👆
向上	向上 👆
往上	往上 👆
往上指	往上指 👆
上面	上面 👆
上边	上边 👆
反手食指向下指	反手食指向下指 👇
向下指	向下指 👇
向下	向下 👇
往下	往下 👇
往下指	往下指 👇
下面	下面 👇
下边	下边 👇
中指	中指 🖕
竖中指	竖中指 🖕
比中指	比中指 🖕
举中指	举中指 🖕
食指	食指 ☝️
一个	一个 ☝️
第一	第一 ☝️
食指指向观察者	食指指向观察者 🫵
指向观察者的食指	指向观察者的食指 🫵
你自己	你自己 🫵
就是你	就是你 🫵
指着	指着 🫵
指着你	指着你 🫵
指你	指你 🫵
指我	指我 🫵
指人	指人 🫵
拇指	拇指 👍 👎
大拇指	大拇指 👍 👎
大拇指向上	大拇指向上 👍
拇指向上	拇指向上 👍 👎
大拇指朝上	大拇指朝上 👍
拇指朝上	拇指朝上 👍
强	强 👍
棒	棒 👍
棒啊	棒啊 👍
真棒	真棒 👍
好棒	好棒 👍
很棒	很棒 👍
特棒	特棒 👍
非常棒	非常棒 👍
棒棒	棒棒 👍
棒棒的	棒棒的 👍
棒棒哒	棒棒哒 👍
太棒	太棒 👍
太棒了	太棒了 👍
太棒啦	太棒啦 👍
干得好	干得好 👍
很好	很好 👍
不错	不错 👍
表扬	表扬 👍
牛逼	牛逼 👍
厉害	厉害 👍
赞	赞 👍
点赞	点赞 👍
绝了	绝了 👍
大拇指向下	大拇指向下 👎
大拇指朝下	大拇指朝下 👎
拇指朝下	拇指朝下 👎
不好	不好 👎
不强	不强 👎
不棒	不棒 👎
太差	太差 👎
太差了	太差了 👎
太差啦	太差啦 👎
差劲	差劲 👎
举起拳头	举起拳头 ✊
举起的拳头	举起的拳头 ✊
握拳	握拳 ✊
握紧的拳头	握紧的拳头 👊
拳头	拳头 👊
出拳	出拳 👊
打击	打击 👊
重拳出击	重拳出击 👊
打你	打你 👊
揍你	揍你 👊
干你	干你 👊
左向拳	左向拳 🤛
朝左的拳头	朝左的拳头 🤛
右钩拳	右钩拳 🤛
右拳	右拳 🤛
右向拳	右向拳 🤜
朝右的拳头	朝右的拳头 🤜
左钩拳	左钩拳 🤜
左拳	左拳 🤜
鼓掌	鼓掌 👏
拍手	拍手 👏
拍掌	拍掌 👏
啪啪啪	啪啪啪 👏
扬手欢呼	扬手欢呼 🙌
举双手	举双手 🙌
做成心形的双手	做成心形的双手 🫶
双手张开	双手张开 👐
张开双手	张开双手 👐
双手手掌向上	双手手掌向上 🤲
掌心向上托起	掌心向上托起 🤲
双手	双手 🤲
捧着	捧着 🤲
握手	握手 🤝
合作	合作 🤝
合作愉快	合作愉快 🤝
搞定	搞定 🤝
双手合十	双手合十 🙏
合十	合十 🙏
合掌	合掌 🙏
拜托	拜托 🙏
祈求	祈求 🙏
祈祷	祈祷 🙏
感谢	感谢 🙏
谢谢	谢谢 🙏
超度	超度 🙏
阿弥陀佛	阿弥陀佛 🙏
写字	写字 ✍️
手写	手写 ✍️
指甲油	指甲油 💅
涂指甲油	涂指甲油 💅
美甲	美甲 💅
做指甲	做指甲 💅
做美甲	做美甲 💅
自拍	自拍 🤳
二头肌	二头肌 💪
肱二头肌	肱二头肌 💪
肱二头	肱二头 💪
强壮	强壮 💪
肌肉	肌肉 💪
秀肌肉	秀肌肉 💪
健身	健身 💪
奋斗	奋斗 💪
努力	努力 💪
义肢	义肢 🦾 🦿
义体	义体 🦾 🦿
赛博朋克	赛博朋克 🦾 🦿
机械手臂	机械手臂 🦾
机械臂	机械臂 🦾
机械腿	机械腿 🦿
腿	腿 🦵
腿儿	腿儿 🦵
大腿	大腿 🦵
练腿	练腿 🦵
脚	脚 🦶
足	足 🦶
踢	踢 🦶
踩	踩 🦶
脚丫	脚丫 🦶
脚丫子	脚丫子 🦶
听	听 👂
耳	耳 👂
耳朵	耳朵 👂
助听器	助听器 🦻
听力障碍	听力障碍 🦻
戴助听器的耳朵	戴助听器的耳朵 🦻
嗅	嗅 👃
闻	闻 👃
鼻	鼻 👃
鼻子	鼻子 👃
呼吸	呼吸 👃
大脑	大脑 🧠
头脑	头脑 🧠
脑花	脑花 🧠
脑子	脑子 🧠
脑	脑 🧠
心脏	心脏 🫀
心脏器官	心脏器官 🫀
肺	肺 🫁
吸气	吸气 🫁
呼吸作用	呼吸作用 🫁
牙	牙 🦷
牙齿	牙齿 🦷
牙牙	牙牙 🦷
骨头	骨头 🦴
骨骼	骨骼 🦴
眼	眼 👀 👁
眼睛	眼睛 👀 👁
注视	注视 👀
观察	观察 👀
看	看 👀
看看	看看 👀
单眼	单眼 👁
一只眼	一只眼 👁
一只眼睛	一只眼睛 👁
舌	舌 👅
舌头	舌头 👅
口	口 👄
嘴	嘴 👄
嘴唇	嘴唇 👄
嘴巴	嘴巴 👄
咬嘴唇	咬嘴唇 🫦
咬住嘴唇	咬住嘴唇 🫦
调情	调情 🫦
情调	情调 🫦
诱惑	诱惑 🫦
婴儿	婴儿 👶 🚼
宝宝	宝宝 👶 🚼
小宝贝	小宝贝 👶
小宝贝儿	小宝贝儿 👶
baby	baby 👶 🚼
乖宝	乖宝 👶
乖宝宝	乖宝宝 👶
儿童	儿童 🧒
小孩	小孩 🧒
小孩儿	小孩儿 🧒
孩子	孩子 🧒
小孩子	小孩子 🧒
小朋友	小朋友 🧒
小盆友	小盆友 🧒
男孩	男孩 👦
小男孩	小男孩 👦
儿子	儿子 👦
女孩	女孩 👧
小女孩	小女孩 👧
女儿	女儿 👧
金发	金发 👱 👱‍♀️ 👱‍♂️
金色头发	金色头发 👱 👱‍♀️ 👱‍♂️
金发女	金发女 👱 👱‍♀️
金发女子	金发女子 👱 👱‍♀️
金发女人	金发女人 👱 👱‍♀️
男人	男人 👨
成年男人	成年男人 👨
成年男性	成年男性 👨
爸爸	爸爸 👨
父亲	父亲 👨
老爹	老爹 👨
有胡须的人	有胡须的人 🧔
有胡子的人	有胡子的人 🧔
络腮胡	络腮胡 🧔
胡子	胡子 🧔
胡须	胡须 🧔
大叔	大叔 🧔
长胡子的女人	长胡子的女人 🧔‍♀️
胡子女	胡子女 🧔‍♀️
红发	红发 👨‍🦰 👩‍🦰 🦰
红色头发	红色头发 👨‍🦰 👩‍🦰 🦰
红发男	红发男 👨‍🦰 👨‍🦱
红发男子	红发男子 👨‍🦰 👨‍🦱
红发男人	红发男人 👨‍🦰 👨‍🦱
卷发	卷发 👨‍🦱 👩‍🦱 🦱
白发	白发 👨‍🦳 👩‍🦳 🦳
白色头发	白色头发 👨‍🦳 👩‍🦳
白发男	白发男 👨‍🦳
白发男子	白发男子 👨‍🦳
白发男人	白发男人 👨‍🦳
光头	光头 👨‍🦲 👩‍🦲 🦲
光头男	光头男 👨‍🦲
光头男子	光头男子 👨‍🦲
光头男人	光头男人 👨‍🦲
秃顶	秃顶 👨‍🦲 👩‍🦲 🦲
秃头	秃头 👨‍🦲 👩‍🦲 🦲
头秃	头秃 👨‍🦲 👩‍🦲 🦲
脱发	脱发 👨‍🦲 👩‍🦲 🦲
和尚	和尚 👨‍🦲
女人	女人 👩
成年女人	成年女人 👩
成年女性	成年女性 👩
妈妈	妈妈 👩
母亲	母亲 👩
老妈	老妈 👩
红头发	红头发 👩‍🦰 🦰
红发女	红发女 👩‍🦰
红发女子	红发女子 👩‍🦰
红发女人	红发女人 👩‍🦰
卷发女	卷发女 👩‍🦱
卷发女子	卷发女子 👩‍🦱
卷发女人	卷发女人 👩‍🦱
白发女	白发女 👩‍🦳
白发女子	白发女子 👩‍🦳
白发女人	白发女人 👩‍🦳
光头女	光头女 👩‍🦲
光头女子	光头女子 👩‍🦲
光头女人	光头女人 👩‍🦲
尼姑	尼姑 👩‍🦲
金发男	金发男 👱‍♂️
金发男子	金发男子 👱‍♂️
金发男人	金发男人 👱‍♂️
老人	老人 👴 👵
老头	老头 👴
老头儿	老头儿 👴
老爷爷	老爷爷 👴
爷爷	爷爷 👴
姥爷	姥爷 👴
外公	外公 👴
祖父	祖父 👴
老太太	老太太 👵
老奶奶	老奶奶 👵
奶奶	奶奶 👵
姥姥	姥姥 👵
外婆	外婆 👵
祖母	祖母 👵
皱着眉头	皱着眉头 🙍‍♂️ 🙍‍♀️
皱着眉头的人	皱着眉头的人 🙍‍♂️ 🙍‍♀️
噘嘴的人	噘嘴的人 🙎‍♂️ 🙎‍♀️
禁止手势	禁止手势 🙅‍♂️ 🙅‍♀️
不	不 🙅‍♂️ 🙅‍♀️
不行	不行 🙅‍♂️ 🙅‍♀️
反对	反对 🙅‍♂️ 🙅‍♀️
拒绝	拒绝 🙅‍♂️ 🙅‍♀️
不同意	不同意 🙅‍♂️ 🙅‍♀️
不可以	不可以 🙅‍♂️ 🙅‍♀️
同意	同意 🙆‍♂️ 🙆‍♀️
可以	可以 🙆‍♂️ 🙆‍♀️ 🉑
服务员	服务员 💁‍♂️ 💁‍♀️
男服务员	男服务员 💁‍♂️
女服务员	女服务员 💁‍♀️
举手	举手 🙋‍♂️ 🙋‍♀️
我知道	我知道 🙋‍♂️ 🙋‍♀️
这个我知道	这个我知道 🙋‍♂️ 🙋‍♀️
失聪者	失聪者 🧏‍♂️ 🧏‍♀️
失聪	失聪 🧏‍♂️ 🧏‍♀️
耳聋	耳聋 🧏‍♂️ 🧏‍♀️
聋子	聋子 🧏‍♂️ 🧏‍♀️
不好意思	不好意思 🙇‍♂️ 🙇‍♀️
对不起	对不起 🙇‍♂️ 🙇‍♀️
道歉	道歉 🙇‍♂️ 🙇‍♀️
鞠躬	鞠躬 🙇‍♂️ 🙇‍♀️
跪求	跪求 🙇‍♂️ 🙇‍♀️
捂脸	捂脸 🤦‍♂️ 🤦‍♀️
手掌捂脸	手掌捂脸 🤦‍♂️ 🤦‍♀️
扶额	扶额 🤦‍♂️ 🤦‍♀️
服了	服了 🤦‍♂️ 🤦‍♀️
我服了	我服了 🤦‍♂️ 🤦‍♀️
服了你了	服了你了 🤦‍♂️ 🤦‍♀️
我服了你	我服了你 🤦‍♂️ 🤦‍♀️
我服了你了	我服了你了 🤦‍♂️ 🤦‍♀️
耸肩	耸肩 🤷‍♂️ 🤷‍♀️
不关心	不关心 🤷‍♂️ 🤷‍♀️
不知道	不知道 🤷‍♂️ 🤷‍♀️
谁知道	谁知道 🤷‍♂️ 🤷‍♀️
谁知道呢	谁知道呢 🤷‍♂️ 🤷‍♀️
医护人员	医护人员 👨‍⚕️ 👩‍⚕️
医生	医生 👨‍⚕️ 👩‍⚕️
男医护人员	男医护人员 👨‍⚕️
男医生	男医生 👨‍⚕️
大夫	大夫 👨‍⚕️ 👩‍⚕️
男大夫	男大夫 👨‍⚕️
女医护人员	女医护人员 👩‍⚕️
女医生	女医生 👩‍⚕️
女大夫	女大夫 👩‍⚕️
学生	学生 👨‍🎓 👩‍🎓
大学生	大学生 👨‍🎓 👩‍🎓
男学生	男学生 👨‍🎓
毕业	毕业 👨‍🎓 👩‍🎓
本科生	本科生 👨‍🎓 👩‍🎓
女学生	女学生 👩‍🎓
老师	老师 👨‍🏫 👩‍🏫
教师	教师 👨‍🏫 👩‍🏫
男老师	男老师 👨‍🏫
男教师	男教师 👨‍🏫
女老师	女老师 👩‍🏫
女教师	女教师 👩‍🏫
法官	法官 👨‍⚖️ 👩‍⚖️
男法官	男法官 👨‍⚖️
女法官	女法官 👩‍⚖️
农民	农民 👨‍🌾 👩‍🌾
农夫	农夫 👨‍🌾
农妇	农妇 👩‍🌾
做饭	做饭 👨‍🍳 👩‍🍳
厨师	厨师 👨‍🍳 👩‍🍳
大厨	大厨 👨‍🍳 👩‍🍳
男厨师	男厨师 👨‍🍳
下厨	下厨 👨‍🍳 👩‍🍳
女厨师	女厨师 👩‍🍳
技工	技工 👨‍🔧 👩‍🔧
水管工	水管工 👨‍🔧 👩‍🔧
电工	电工 👨‍🔧 👩‍🔧
修理工	修理工 👨‍🔧 👩‍🔧
男技工	男技工 👨‍🔧
男水管工	男水管工 👨‍🔧
男电工	男电工 👨‍🔧
男修理工	男修理工 👨‍🔧
女技工	女技工 👩‍🔧
女水管工	女水管工 👩‍🔧
女电工	女电工 👩‍🔧
女修理工	女修理工 👩‍🔧
工厂工人	工厂工人 👨‍🏭 👩‍🏭
男工厂工人	男工厂工人 👨‍🏭
女工厂工人	女工厂工人 👩‍🏭
办公室职员	办公室职员 👨‍💼 👩‍💼
职员	职员 👨‍💼 👩‍💼
白领	白领 👨‍💼 👩‍💼
男办公室职员	男办公室职员 👨‍💼
男职员	男职员 👨‍💼
男白领	男白领 👨‍💼
女办公室职员	女办公室职员 👩‍💼
女职员	女职员 👩‍💼
女白领	女白领 👩‍💼
科学家	科学家 👨‍🔬 👩‍🔬
化学家	化学家 👨‍🔬 👩‍🔬
男科学家	男科学家 👨‍🔬
男化学家	男化学家 👨‍🔬
女科学家	女科学家 👩‍🔬
女化学家	女化学家 👩‍🔬
程序员	程序员 👨‍💻 👩‍💻
码农	码农 👨‍💻 👩‍💻
码畜	码畜 👨‍💻 👩‍💻
开发人员	开发人员 👨‍💻 👩‍💻
技术员	技术员 👨‍💻 👩‍💻
男程序员	男程序员 👨‍💻
男码农	男码农 👨‍💻
男码畜	男码畜 👨‍💻
男开发人员	男开发人员 👨‍💻
男技术员	男技术员 👨‍💻
女程序员	女程序员 👩‍💻
女码农	女码农 👩‍💻
女码畜	女码畜 👩‍💻
女开发人员	女开发人员 👩‍💻
女技术员	女技术员 👩‍💻
歌手	歌手 👨‍🎤 👩‍🎤
男歌手	男歌手 👨‍🎤
摇滚歌手	摇滚歌手 👨‍🎤 👩‍🎤
摇滚男歌手	摇滚男歌手 👨‍🎤
男摇滚歌手	男摇滚歌手 👨‍🎤
朋克	朋克 👨‍🎤 👩‍🎤
重金属	重金属 👨‍🎤 👩‍🎤
女歌手	女歌手 👩‍🎤
摇滚女歌手	摇滚女歌手 👩‍🎤
女摇滚歌手	女摇滚歌手 👩‍🎤
艺术家	艺术家 👨‍🎨 👩‍🎨
男艺术家	男艺术家 👨‍🎨
画家	画家 👨‍🎨 👩‍🎨
男画家	男画家 👨‍🎨
漫画家	漫画家 👨‍🎨 👩‍🎨
男漫画家	男漫画家 👨‍🎨
女艺术家	女艺术家 👩‍🎨
女画家	女画家 👩‍🎨
女漫画家	女漫画家 👩‍🎨
飞行员	飞行员 👨‍✈️ 👩‍✈️
男飞行员	男飞行员 👨‍✈️
女飞行员	女飞行员 👩‍✈️
宇航员	宇航员 👨‍🚀 👩‍🚀
男宇航员	男宇航员 👨‍🚀
女宇航员	女宇航员 👩‍🚀
消防员	消防员 👨‍🚒 👩‍🚒
男消防员	男消防员 👨‍🚒
女消防员	女消防员 👩‍🚒
警官	警官 👮‍♂️ 👮‍♀️
警察	警察 👮‍♂️ 👮‍♀️
男警官	男警官 👮‍♂️
男警察	男警察 👮‍♂️
女警官	女警官 👮‍♀️
女警察	女警察 👮‍♀️
侦探	侦探 🕵️‍♂️ 🕵️‍♀️
男侦探	男侦探 🕵️‍♂️
女侦探	女侦探 🕵️‍♀️
卫兵	卫兵 💂‍♂️ 💂‍♀️
卫士	卫士 💂‍♂️ 💂‍♀️
男卫兵	男卫兵 💂‍♂️
男卫士	男卫士 💂‍♂️
女卫兵	女卫兵 💂‍♀️
女卫士	女卫士 💂‍♀️
忍者	忍者 🥷
忍术	忍术 🥷
工人	工人 👷‍♂️ 👷‍♀️
建筑工	建筑工 👷‍♂️ 👷‍♀️
建筑工人	建筑工人 👷‍♂️ 👷‍♀️
农民工	农民工 👷‍♂️ 👷‍♀️
男工人	男工人 👷‍♂️
男建筑工	男建筑工 👷‍♂️
男建筑工人	男建筑工人 👷‍♂️
男农民工	男农民工 👷‍♂️
女工人	女工人 👷‍♀️
女建筑工	女建筑工 👷‍♀️
女建筑工人	女建筑工人 👷‍♀️
女农民工	女农民工 👷‍♀️
君主	君主 🫅
戴王冠的人	戴王冠的人 🫅
王子	王子 🤴
小王子	小王子 🤴
国王	国王 🤴
公主	公主 👸
小公主	小公主 👸
女王	女王 👸
女皇	女皇 👸
头巾	头巾 👳‍♂️ 👳‍♀️ 🧕
戴头巾	戴头巾 👳‍♂️ 👳‍♀️
戴头巾的人	戴头巾的人 👳‍♂️ 👳‍♀️
中国帽	中国帽 👲
瓜皮帽	瓜皮帽 👲
地主	地主 👲
穆斯林	穆斯林 🧕
新郎	新郎 🤵‍♂️
礼服	礼服 🤵‍♂️
燕尾服	燕尾服 🤵‍♂️
西服	西服 🤵‍♂️
女新郎	女新郎 🤵‍♀️
男新娘	男新娘 👰‍♂️
戴头纱的人	戴头纱的人 👰‍♀️
头纱	头纱 👰‍♀️
婚纱	婚纱 👰‍♀️
新娘	新娘 👰‍♀️
新娘子	新娘子 👰‍♀️
孕妇	孕妇 🤰
怀孕	怀孕 🤰
大肚子	大肚子 🤰 🫃
怀了	怀了 🤰
孕肚	孕肚 🤰
男人怀孕	男人怀孕 🫃
怀孕的男人	怀孕的男人 🫃
啤酒肚	啤酒肚 🫃
将军肚	将军肚 🫃
哺乳	哺乳 🤱 👩‍🍼
母乳	母乳 🤱
母乳喂养	母乳喂养 🤱
喂奶	喂奶 🤱
哺乳的女人	哺乳的女人 👩‍🍼
奶妈	奶妈 👩‍🍼
哺乳的男人	哺乳的男人 👨‍🍼
奶爸	奶爸 👨‍🍼
天使宝宝	天使宝宝 👼
小天使	小天使 👼
圣诞老人	圣诞老人 🎅
圣诞夫人	圣诞夫人 🤶
圣诞奶奶	圣诞奶奶 🤶
超人	超人 🦸‍♂️ 🦸‍♀️
超级英雄	超级英雄 🦸‍♂️ 🦸‍♀️
男超人	男超人 🦸‍♂️
男超级英雄	男超级英雄 🦸‍♂️
女超人	女超人 🦸‍♀️
女超级英雄	女超级英雄 🦸‍♀️
反派	反派 🦹‍♂️ 🦹‍♀️
坏蛋	坏蛋 🦹‍♂️ 🦹‍♀️
超级大反派	超级大反派 🦹‍♂️ 🦹‍♀️
大反派	大反派 🦹‍♂️ 🦹‍♀️
男反派	男反派 🦹‍♂️
男坏蛋	男坏蛋 🦹‍♂️
男超级大反派	男超级大反派 🦹‍♂️
男大反派	男大反派 🦹‍♂️
女反派	女反派 🦹‍♀️
女坏蛋	女坏蛋 🦹‍♀️
女超级大反派	女超级大反派 🦹‍♀️
女大反派	女大反派 🦹‍♀️
法师	法师 🧙‍♂️ 🧙‍♀️
魔法师	魔法师 🧙‍♂️ 🧙‍♀️
魔术师	魔术师 🧙‍♂️ 🧙‍♀️
男法师	男法师 🧙‍♂️
男魔法师	男魔法师 🧙‍♂️
男魔术师	男魔术师 🧙‍♂️
男巫	男巫 🧙‍♂️
女法师	女法师 🧙‍♀️
女魔法师	女魔法师 🧙‍♀️
女魔术师	女魔术师 🧙‍♀️
女巫	女巫 🧙‍♀️
精灵	精灵 🧚‍♂️ 🧚‍♀️ 🧝‍♂️ 🧝‍♀️
小精灵	小精灵 🧚‍♂️ 🧚‍♀️
小仙子	小仙子 🧚‍♂️ 🧚‍♀️
小仙女	小仙女 🧚‍♀️
吸血鬼	吸血鬼 🧛‍♂️ 🧛‍♀️
德古拉	德古拉 🧛‍♂️ 🧛‍♀️
男吸血鬼	男吸血鬼 🧛‍♂️
女吸血鬼	女吸血鬼 🧛‍♀️
人鱼	人鱼 🧜‍♂️ 🧜‍♀️
美男鱼	美男鱼 🧜‍♂️
男人鱼	男人鱼 🧜‍♂️
美人鱼	美人鱼 🧜‍♀️
男精灵	男精灵 🧝‍♂️
精灵族	精灵族 🧝‍♂️ 🧝‍♀️
女精灵	女精灵 🧝‍♀️
阿拉丁	阿拉丁 🧞‍♂️ 🧞‍♀️
阿拉丁神灯	阿拉丁神灯 🧞‍♂️ 🧞‍♀️
灯神	灯神 🧞‍♂️ 🧞‍♀️
男灯神	男灯神 🧞‍♂️
女灯神	女灯神 🧞‍♀️
僵尸	僵尸 🧟‍♂️ 🧟‍♀️
丧尸	丧尸 🧟‍♂️ 🧟‍♀️
行尸走肉	行尸走肉 🧟‍♂️ 🧟‍♀️
男僵尸	男僵尸 🧟‍♂️
男丧尸	男丧尸 🧟‍♂️
男行尸走肉	男行尸走肉 🧟‍♂️
女僵尸	女僵尸 🧟‍♀️
女丧尸	女丧尸 🧟‍♀️
女行尸走肉	女行尸走肉 🧟‍♀️
巨怪	巨怪 🧌
穴居巨怪	穴居巨怪 🧌
按摩	按摩 💆‍♂️ 💆‍♀️
美容	美容 💆‍♂️ 💆‍♀️
剪头	剪头 💇‍♂️ 💇‍♀️
剪发	剪发 💇‍♂️ 💇‍♀️
理发	理发 💇‍♂️ 💇‍♀️
理头	理头 💇‍♂️ 💇‍♀️
剪头发	剪头发 💇‍♂️ 💇‍♀️
理头发	理头发 💇‍♂️ 💇‍♀️
做造型	做造型 💇‍♂️ 💇‍♀️
美容美发	美容美发 💇‍♂️ 💇‍♀️
走路	走路 🚶‍♂️ 🚶‍♀️
徒步	徒步 🚶‍♂️ 🚶‍♀️
行走	行走 🚶‍♂️ 🚶‍♀️
站着	站着 🧍‍♂️ 🧍‍♀️
站立	站立 🧍‍♂️ 🧍‍♀️
站立者	站立者 🧍‍♂️ 🧍‍♀️
站立的男人	站立的男人 🧍‍♂️
哥哥	哥哥 🧍‍♂️
弟弟	弟弟 🧍‍♂️
男仔	男仔 🧍‍♂️
站立的女人	站立的女人 🧍‍♀️
姐姐	姐姐 🧍‍♀️
妹妹	妹妹 🧍‍♀️
女仔	女仔 🧍‍♀️
跪坐	跪坐 🧎‍♂️ 🧎‍♀️
拄盲杖的人	拄盲杖的人 👨‍🦯 👩‍🦯
拿着白手杖的人	拿着白手杖的人 👨‍🦯 👩‍🦯
坐电动轮椅的人	坐电动轮椅的人 👨‍🦼 👩‍🦼
坐电动轮椅的男人	坐电动轮椅的男人 👨‍🦼
电动轮椅	电动轮椅 👨‍🦼 👩‍🦼 🦼
坐电动轮椅的女人	坐电动轮椅的女人 👩‍🦼
坐手动轮椅的人	坐手动轮椅的人 👨‍🦽 👩‍🦽
坐手动轮椅的男人	坐手动轮椅的男人 👨‍🦽
手动轮椅	手动轮椅 👨‍🦽 👩‍🦽 🦽
坐手动轮椅的女人	坐手动轮椅的女人 👩‍🦽
跑步	跑步 🏃‍♂️ 🏃‍♀️
跑步者	跑步者 🏃‍♂️ 🏃‍♀️
马拉松	马拉松 🏃‍♂️ 🏃‍♀️
跳舞	跳舞 💃 🕺
跳舞的女人	跳舞的女人 💃
舞女	舞女 💃
跳舞的男人	跳舞的男人 🕺
舞者	舞者 🕺
浮在地面上的西装男	浮在地面上的西装男 🕴
兔先生	兔先生 👯‍♂️
兔耳朵	兔耳朵 👯‍♂️ 👯‍♀️
兔女郎	兔女郎 👯‍♀️
桑拿	桑拿 🧖‍♂️ 🧖‍♀️
蒸房	蒸房 🧖‍♂️ 🧖‍♀️
蒸桑拿	蒸桑拿 🧖‍♂️ 🧖‍♀️
蒸房里的人	蒸房里的人 🧖‍♂️ 🧖‍♀️
蒸房里的男人	蒸房里的男人 🧖‍♂️
蒸房里的女人	蒸房里的女人 🧖‍♀️
攀岩者	攀岩者 🧗‍♂️ 🧗‍♀️
攀爬的人	攀爬的人 🧗‍♂️ 🧗‍♀️
登山者	登山者 🧗‍♂️ 🧗‍♀️
登山	登山 🧗‍♂️ 🧗‍♀️
攀山	攀山 🧗‍♂️ 🧗‍♀️
攀爬的男人	攀爬的男人 🧗‍♂️
攀爬的女人	攀爬的女人 🧗‍♀️
击剑者	击剑者 🤺
击剑	击剑 🤺
击剑选手	击剑选手 🤺
赛马	赛马 🏇
骑马	骑马 🏇
赛马骑师	赛马骑师 🏇
滑雪	滑雪 ⛷️
滑雪的人	滑雪的人 ⛷️
单板滑雪	单板滑雪 🏂
滑雪板	滑雪板 🏂
高尔夫球手	高尔夫球手 🏌️‍♂️ 🏌️‍♀️
打高尔夫的人	打高尔夫的人 🏌️‍♂️ 🏌️‍♀️
高尔夫	高尔夫 🏌️‍♂️ 🏌️‍♀️ ⛳
打高尔夫	打高尔夫 🏌️‍♂️ 🏌️‍♀️
冲浪者	冲浪者 🏄‍♂️ 🏄‍♀️
冲浪	冲浪 🏄‍♂️ 🏄‍♀️
男生冲浪	男生冲浪 🏄‍♂️
女生冲浪	女生冲浪 🏄‍♀️
划船	划船 🚣‍♂️ 🚣‍♀️
划艇	划艇 🚣‍♂️ 🚣‍♀️
泛舟	泛舟 🚣‍♂️ 🚣‍♀️
游泳者	游泳者 🏊‍♂️ 🏊‍♀️
游泳	游泳 🏊‍♂️ 🏊‍♀️
泳客	泳客 🏊‍♂️ 🏊‍♀️
男生游泳	男生游泳 🏊‍♂️
女生游泳	女生游泳 🏊‍♀️
篮球运动员	篮球运动员 ⛹️‍♂️ ⛹️‍♀️
打篮球	打篮球 ⛹️‍♂️ ⛹️‍♀️
玩篮球	玩篮球 ⛹️‍♂️ ⛹️‍♀️
举重	举重 🏋️‍♂️ 🏋️‍♀️
举重运动员	举重运动员 🏋️‍♂️ 🏋️‍♀️
男生举重	男生举重 🏋️‍♂️
男举重运动员	男举重运动员 🏋️‍♂️
女生举重	女生举重 🏋️‍♀️
女举重运动员	女举重运动员 🏋️‍♀️
骑车	骑车 🚴‍♂️ 🚴‍♀️
骑单车	骑单车 🚴‍♂️ 🚴‍♀️
骑自行车	骑自行车 🚴‍♂️ 🚴‍♀️
山地车	山地车 🚵‍♂️ 🚵‍♀️
山地自行车	山地自行车 🚵‍♂️ 🚵‍♀️
骑山地车	骑山地车 🚵‍♂️ 🚵‍♀️
侧手翻	侧手翻 🤸‍♂️ 🤸‍♀️
翻筋斗	翻筋斗 🤸‍♂️ 🤸‍♀️
翻跟头	翻跟头 🤸‍♂️ 🤸‍♀️
摔跤	摔跤 🤼‍♂️ 🤼‍♀️
摔跤选手	摔跤选手 🤼‍♂️ 🤼‍♀️
格斗	格斗 🤼‍♂️ 🤼‍♀️
水球	水球 🤽‍♂️ 🤽‍♀️
玩水球	玩水球 🤽‍♂️ 🤽‍♀️
男生玩水球	男生玩水球 🤽‍♂️
女生玩水球	女生玩水球 🤽‍♀️
手球	手球 🤾‍♂️ 🤾‍♀️
玩手球	玩手球 🤾‍♂️ 🤾‍♀️
打手球	打手球 🤾‍♂️ 🤾‍♀️
杂耍	杂耍 🤹‍♂️ 🤹‍♀️
抛接	抛接 🤹‍♂️ 🤹‍♀️
抛接杂耍	抛接杂耍 🤹‍♂️ 🤹‍♀️
莲花坐的人	莲花坐的人 🧘‍♂️ 🧘‍♀️
莲花坐	莲花坐 🧘‍♂️ 🧘‍♀️
全莲花坐	全莲花坐 🧘‍♂️ 🧘‍♀️
冥想	冥想 🧘‍♂️ 🧘‍♀️
瑜伽	瑜伽 🧘‍♂️ 🧘‍♀️
盘腿	盘腿 🧘‍♂️ 🧘‍♀️
打坐	打坐 🧘‍♂️ 🧘‍♀️
瑜伽男	瑜伽男 🧘‍♂️
盘腿的男人	盘腿的男人 🧘‍♂️
瑜伽女	瑜伽女 🧘‍♀️
盘腿的女人	盘腿的女人 🧘‍♀️
洗澡	洗澡 🛀
洗澡的人	洗澡的人 🛀
泡澡	泡澡 🛀
泡澡的人	泡澡的人 🛀
睡觉的人	睡觉的人 🛌
躺在床上的人	躺在床上的人 🛌
床上休息	床上休息 🛌
牵手	牵手 🧑‍🤝‍🧑
手拉手	手拉手 🧑‍🤝‍🧑
两个牵手的女人	两个牵手的女人 👭
两个女人	两个女人 👭
闺蜜	闺蜜 👭
情侣	情侣 👫
牵手的情侣	牵手的情侣 👫
手拉手的情侣	手拉手的情侣 👫
两个牵手的男人	两个牵手的男人 👬
两个男人	两个男人 👬
兄弟	兄弟 👬
基友	基友 👬
好基友	好基友 👬
好兄弟	好兄弟 👬
恋爱	恋爱 👩‍❤️‍👨
谈恋爱	谈恋爱 👩‍❤️‍👨
相爱	相爱 👩‍❤️‍👨
男同	男同 👨‍❤️‍👨
男同性恋	男同性恋 👨‍❤️‍👨
同性恋	同性恋 👨‍❤️‍👨 👩‍❤️‍👩
玻璃	玻璃 👨‍❤️‍👨
女同	女同 👩‍❤️‍👩
女同性恋	女同性恋 👩‍❤️‍👩
拉拉	拉拉 👩‍❤️‍👩
一家人	一家人 👨‍👩‍👦 👨‍👩‍👧 👨‍👩‍👧‍👦 👨‍👩‍👦‍👦 👨‍👩‍👧‍👧
一家三口	一家三口 👨‍👩‍👦 👨‍👩‍👧
三口之家	三口之家 👨‍👩‍👦 👨‍👩‍👧
一家四口	一家四口 👨‍👩‍👧‍👦 👨‍👩‍👦‍👦 👨‍👩‍👧‍👧
四口之家	四口之家 👨‍👩‍👧‍👦 👨‍👩‍👦‍👦 👨‍👩‍👧‍👧
父子	父子 👨‍👦
父女	父女 👨‍👧
母子	母子 👩‍👦
母女	母女 👩‍👧
剪影	剪影 🗣 👤 👥 🫂
讲话	讲话 🗣
讲话者	讲话者 🗣
讲话者的头部剪影	讲话者的头部剪影 🗣
头部剪影	头部剪影 🗣
人物剪影	人物剪影 👤
半身像	半身像 👤 👥
头像	头像 👤
双人像	双人像 👥
双人	双人 👥
拥抱的人	拥抱的人 🫂
抱在一起	抱在一起 🫂
脚印	脚印 👣
足迹	足迹 👣
肤色	肤色 🏻 🏼 🏽 🏾 🏿
浅肤色	浅肤色 🏻
中等浅肤色	中等浅肤色 🏼
较浅肤色	较浅肤色 🏼
中等肤色	中等肤色 🏽
中等深肤色	中等深肤色 🏾
较深肤色	较深肤色 🏾
深肤色	深肤色 🏿
赤发	赤发 🦰
猴	猴 🐵 🐒
猴脸	猴脸 🐵
猴头	猴头 🐵
猴子	猴子 🐒
大猩猩	大猩猩 🦍
猩猩	猩猩 🦍 🦧
红毛猩猩	红毛猩猩 🦧
人猿	人猿 🦧
狗	狗 🐶 🐕
狗脸	狗脸 🐶
狗头	狗头 🐶
小狗	小狗 🐶 🐕
Doge	Doge 🐶
旺柴	旺柴 🐶
旺财	旺财 🐶
狗仔	狗仔 🐶
犬	犬 🐕
狗子	狗子 🐕
狗狗	狗狗 🐕
导盲犬	导盲犬 🦮
金毛	金毛 🦮
金毛犬	金毛犬 🦮
金毛寻回犬	金毛寻回犬 🦮
工作犬	工作犬 🐕‍🦺
服务犬	服务犬 🐕‍🦺
贵宾犬	贵宾犬 🐩
卷毛狗	卷毛狗 🐩
狼	狼 🐺
狼脸	狼脸 🐺
狼头	狼头 🐺
狐狸	狐狸 🦊
狐狸脸	狐狸脸 🦊
狐狸偷	狐狸偷 🦊
浣熊	浣熊 🦝
小浣熊	小浣熊 🦝
干脆面	干脆面 🦝
干脆面君	干脆面君 🦝
猫	猫 🐱
猫咪	猫咪 🐱 🐈
小猫咪	小猫咪 🐱 🐈
猫脸	猫脸 🐱
猫头	猫头 🐱
小猫	小猫 🐱 🐈
喵	喵 🐱
喵喵	喵喵 🐱
喵喵喵	喵喵喵 🐱
喵喵叫	喵喵叫 🐱
橘猫	橘猫 🐈
黑猫	黑猫 🐈‍⬛
小黑猫	小黑猫 🐈‍⬛
狮	狮 🦁
狮子	狮子 🦁
狮脸	狮脸 🦁
狮头	狮头 🦁
狮子脸	狮子脸 🦁
狮子头	狮子头 🦁
虎	虎 🐯
虎脸	虎脸 🐯
虎头	虎头 🐯
老虎	老虎 🐯 🐅
老虎脸	老虎脸 🐯
老虎头	老虎头 🐯
猎豹	猎豹 🐆
豹	豹 🐆
豹子	豹子 🐆
马	马 🐴 🐎
马儿	马儿 🐴 🐎
马脸	马脸 🐴
马头	马头 🐴
驼鹿	驼鹿 🫎
驼鹿脸	驼鹿脸 🫎
驼鹿头	驼鹿头 🫎
驴	驴 🫏
小驴	小驴 🫏
驴儿	驴儿 🫏
小马	小马 🐎
骏马	骏马 🐎
独角兽	独角兽 🦄
独角兽脸	独角兽脸 🦄
独角兽头	独角兽头 🦄
斑马	斑马 🦓
鹿	鹿 🦌
麋鹿	麋鹿 🦌
大野牛	大野牛 🦬
野牛	野牛 🦬
牛	牛 🐮
牛脸	牛脸 🐮
牛头	牛头 🐮
公牛	公牛 🐂
水牛	水牛 🐃
奶牛	奶牛 🐄
猪	猪 🐷 🐖
猪脸	猪脸 🐷
猪头	猪头 🐷
懒猪	懒猪 🐷
小猪	小猪 🐷
野猪	野猪 🐗
猪鼻子	猪鼻子 🐽
猪鼻	猪鼻 🐽
公羊	公羊 🐏
绵羊	绵羊 🐑
羊	羊 🐑
小羊	小羊 🐑
山羊	山羊 🐐
骆驼	骆驼 🐪 🐫
单峰骆驼	单峰骆驼 🐪
双峰骆驼	双峰骆驼 🐫
羊驼	羊驼 🦙
草泥马	草泥马 🦙
长颈鹿	长颈鹿 🦒
大象	大象 🐘
猛犸象	猛犸象 🦣
犀牛	犀牛 🦏
河马	河马 🦛
老鼠	老鼠 🐭 🐁 🐀
耗子	耗子 🐭 🐁 🐀
鼠脸	鼠脸 🐭
鼠	鼠 🐭
老鼠脸	老鼠脸 🐭
鼠头	鼠头 🐭
老鼠头	老鼠头 🐭
小白鼠	小白鼠 🐁
仓鼠	仓鼠 🐹
仓鼠脸	仓鼠脸 🐹
仓鼠头	仓鼠头 🐹
兔	兔 🐰
兔子	兔子 🐰 🐇
兔脸	兔脸 🐰
兔子脸	兔子脸 🐰
兔头	兔头 🐰
兔子头	兔子头 🐰
小兔子	小兔子 🐇
小白兔	小白兔 🐇
大白兔	大白兔 🐇
松鼠	松鼠 🐿
花栗鼠	花栗鼠 🐿
河狸	河狸 🦫
海狸	海狸 🦫
刺猬	刺猬 🦔
蝙蝠	蝙蝠 🦇
熊	熊 🐻
熊脸	熊脸 🐻
熊头	熊头 🐻
小熊	小熊 🐻
北极熊	北极熊 🐻‍❄️
北极熊脸	北极熊脸 🐻‍❄️
北极熊头	北极熊头 🐻‍❄️
考拉	考拉 🐨
树袋熊	树袋熊 🐨
无尾熊	无尾熊 🐨
熊猫	熊猫 🐼
大熊猫	大熊猫 🐼
猫熊	猫熊 🐼
胖达	胖达 🐼
国宝	国宝 🐼
熊猫脸	熊猫脸 🐼
熊猫头	熊猫头 🐼
熊猫人	熊猫人 🐼
panda	panda 🐼
树懒	树懒 🦥
树懒先生	树懒先生 🦥
慢吞吞	慢吞吞 🦥
水獭	水獭 🦦
海獭	海獭 🦦
鼬	鼬 🦨
臭鼬	臭鼬 🦨
袋鼠	袋鼠 🦘
獾	獾 🦡
蜜獾	蜜獾 🦡
掌印	掌印 🐾
爪印	爪印 🐾
火鸡	火鸡 🦃
鸡	鸡 🐔
鸡头	鸡头 🐔
鸡巴	鸡巴 🐔
公鸡	公鸡 🐓
母鸡	母鸡 🐓
大公鸡	大公鸡 🐓
大母鸡	大母鸡 🐓
孵化小鸡	孵化小鸡 🐣
小鸡	小鸡 🐣 🐤 🐥
小鸡破壳	小鸡破壳 🐣
破壳	破壳 🐣
小鸡头	小鸡头 🐤
小鸡鸡	小鸡鸡 🐥
鸟	鸟 🐦
鸟头	鸟头 🐦
小鸟	小鸟 🐦
企鹅	企鹅 🐧
企鹅头	企鹅头 🐧
鸽子	鸽子 🕊
和平象征	和平象征 🕊
和平的象征	和平的象征 🕊
老鹰	老鹰 🦅
鹰	鹰 🦅
鸭	鸭 🦆
鸭子	鸭子 🦆
小鸭子	小鸭子 🦆
嘎嘎	嘎嘎 🦆
天鹅	天鹅 🦢
白天鹅	白天鹅 🦢
丑小鸭	丑小鸭 🦢
猫头鹰	猫头鹰 🦉
渡渡鸟	渡渡鸟 🦤
羽毛	羽毛 🪶
火烈鸟	火烈鸟 🦩
孔雀	孔雀 🦚
鹦鹉	鹦鹉 🦜
翅膀	翅膀 🪽
天使的翅膀	天使的翅膀 🪽
羽翼	羽翼 🪽
黑鸟	黑鸟 🐦‍⬛
乌鸦	乌鸦 🐦‍⬛
鹅	鹅 🪿
大鹅	大鹅 🪿
鹅鹅鹅	鹅鹅鹅 🪿
青蛙	青蛙 🐸
青蛙头	青蛙头 🐸
青蛙脸	青蛙脸 🐸
蛤蟆	蛤蟆 🐸
蛤蛤	蛤蛤 🐸
蛤	蛤 🐸
鳄鱼	鳄鱼 🐊
乌龟	乌龟 🐢
海龟	海龟 🐢
龟	龟 🐢
蜥蜴	蜥蜴 🦎
蛇	蛇 🐍
小蛇	小蛇 🐍
一条蛇	一条蛇 🐍
Python	Python 🐍
龙	龙 🐲 🐉
龙头	龙头 🐲
龙王	龙王 🐲
中国龙	中国龙 🐲
神龙	神龙 🐉
巨龙	巨龙 🐉
一条龙	一条龙 🐉
恐龙	恐龙 🦕 🦖
腕龙	腕龙 🦕
雷龙	雷龙 🦕
梁龙	梁龙 🦕
霸王龙	霸王龙 🦖
暴龙	暴龙 🦖
喷水的鲸鱼	喷水的鲸鱼 🐳
喷水的鲸	喷水的鲸 🐳
喷水	喷水 🐳
鲸鱼	鲸鱼 🐳 🐋
海豚	海豚 🐬
海豹	海豹 🦭
海狮	海狮 🦭
鱼	鱼 🐟
鱼儿	鱼儿 🐟
小鱼	小鱼 🐟
小鱼儿	小鱼儿 🐟
热带鱼	热带鱼 🐠
河豚	河豚 🐡
鲨鱼	鲨鱼 🦈
大白鲨	大白鲨 🦈
白鲨	白鲨 🦈
章鱼	章鱼 🐙
海螺	海螺 🐚
贝壳	贝壳 🐚
珊瑚	珊瑚 🪸
珊瑚礁	珊瑚礁 🪸
水母	水母 🪼
海蜇	海蜇 🪼
蜗牛	蜗牛 🐌
蝴蝶	蝴蝶 🦋
凤尾蝶	凤尾蝶 🦋
虫子	虫子 🐛
毛毛虫	毛毛虫 🐛
毛虫	毛虫 🐛
bug	bug 🐛
蚂蚁	蚂蚁 🐜
蜜蜂	蜜蜂 🐝
小蜜蜂	小蜜蜂 🐝
昆虫	昆虫 🪲
甲虫	甲虫 🪲
圣甲虫	圣甲虫 🪲
瓢虫	瓢虫 🐞
七星瓢虫	七星瓢虫 🐞
蛐蛐	蛐蛐 🦗
蟋蟀	蟋蟀 🦗
蚱蜢	蚱蜢 🦗
蟑螂	蟑螂 🪳
小强	小强 🪳
蜘蛛	蜘蛛 🕷
蛛网	蛛网 🕸
蜘蛛网	蜘蛛网 🕸
蝎子	蝎子 🦂
蚊蝇	蚊蝇 🦟 🪰
蚊子	蚊子 🦟
蚊虻	蚊虻 🦟
苍蝇	苍蝇 🪰
家蝇	家蝇 🪰
蠕虫	蠕虫 🪱
寄生虫	寄生虫 🪱
蚯蚓	蚯蚓 🪱
微生物	微生物 🦠
变形虫	变形虫 🦠
病毒	病毒 🦠
细菌	细菌 🦠
花束	花束 💐
鲜花	鲜花 💐
捧花	捧花 💐
樱花	樱花 🌸
白色的花	白色的花 💮
白花	白花 💮
莲花	莲花 🪷
花结	花结 🏵
玫瑰花结	玫瑰花结 🏵
玫瑰	玫瑰 🌹
红玫瑰	红玫瑰 🌹
玫瑰花	玫瑰花 🌹
枯萎的玫瑰	枯萎的玫瑰 🥀
枯萎的花	枯萎的花 🥀
枯萎	枯萎 🥀
凋谢	凋谢 🥀
芙蓉	芙蓉 🌺
芙蓉花	芙蓉花 🌺
木槿	木槿 🌺
木槿花	木槿花 🌺
向日葵	向日葵 🌻
太阳花	太阳花 🌻
向阳花	向阳花 🌻
追日花	追日花 🌻
逐日花	逐日花 🌻
花朵	花朵 🌼
开花	开花 🌼
波斯菊	波斯菊 🌼
花	花 🌷
郁金香	郁金香 🌷
风信子	风信子 🪻
幼苗	幼苗 🌱
发芽	发芽 🌱
嫩苗	嫩苗 🌱
盆栽	盆栽 🪴
盆栽植物	盆栽植物 🪴
常青树	常青树 🌲
松树	松树 🌲
树	树 🌳
树木	树木 🌳
大树	大树 🌳
落叶树	落叶树 🌳
棕榈	棕榈 🌴
棕榈树	棕榈树 🌴
仙人掌	仙人掌 🌵
稻穗	稻穗 🌾
水稻	水稻 🌾
草本植物	草本植物 🌿
草药	草药 🌿
药草	药草 🌿
香草	香草 🌿
中药	中药 🌿
三叶草	三叶草 ☘
四叶草	四叶草 🍀
枫叶	枫叶 🍁
枫树叶	枫树叶 🍁
落叶	落叶 🍂
叶子	叶子 🍃
树叶	树叶 🍃
空鸟巢	空鸟巢 🪹
空巢	空巢 🪹
有蛋的鸟巢	有蛋的鸟巢 🪺
有蛋的巢	有蛋的巢 🪺
鸟巢	鸟巢 🪺
蘑菇	蘑菇 🍄
小蘑菇	小蘑菇 🍄
葡萄	葡萄 🍇
提子	提子 🍇
甜瓜	甜瓜 🍈
哈密瓜	哈密瓜 🍈
新疆瓜	新疆瓜 🍈
西瓜	西瓜 🍉
柑橘	柑橘 🍊
橘子	橘子 🍊
蜜橘	蜜橘 🍊
柠檬	柠檬 🍋
香蕉	香蕉 🍌
菠萝	菠萝 🍍
凤梨	凤梨 🍍
芒果	芒果 🥭
苹果	苹果 🍎 🍏
小苹果	小苹果 🍎 🍏
红苹果	红苹果 🍎
青苹果	青苹果 🍏
绿苹果	绿苹果 🍏
梨	梨 🍐
梨子	梨子 🍐
桃	桃 🍑
桃子	桃子 🍑
樱桃	樱桃 🍒
草莓	草莓 🍓
蓝莓	蓝莓 🫐
奇异果	奇异果 🥝
猕猴桃	猕猴桃 🥝
西红柿	西红柿 🍅
番茄	番茄 🍅
橄榄	橄榄 🫒
黄榄	黄榄 🫒
青橄榄	青橄榄 🫒
椰子	椰子 🥥
椰子果	椰子果 🥥
牛油果	牛油果 🥑
鳄梨	鳄梨 🥑
茄子	茄子 🍆
土豆	土豆 🥔
洋芋	洋芋 🥔
马铃薯	马铃薯 🥔
胡萝卜	胡萝卜 🥕
萝卜	萝卜 🥕
红萝卜	红萝卜 🥕
玉米	玉米 🌽
苞米	苞米 🌽
红辣椒	红辣椒 🌶
辣椒	辣椒 🌶
甜椒	甜椒 🫑
菜椒	菜椒 🫑
彩椒	彩椒 🫑
灯笼椒	灯笼椒 🫑
黄瓜	黄瓜 🥒
青瓜	青瓜 🥒
绿叶蔬菜	绿叶蔬菜 🥬
圆白菜	圆白菜 🥬
小白菜	小白菜 🥬
白菜	白菜 🥬
蔬菜	蔬菜 🥬
西兰花	西兰花 🥦
花椰菜	花椰菜 🥦
绿菜花	绿菜花 🥦
青花菜	青花菜 🥦
绿花椰菜	绿花椰菜 🥦
蒜	蒜 🧄
大蒜	大蒜 🧄
蒜香	蒜香 🧄
洋葱	洋葱 🧅
葱头	葱头 🧅
洋蒜	洋蒜 🧅
皮芽子	皮芽子 🧅
花生	花生 🥜
落花生	落花生 🥜
豆子	豆子 🫘
栗子	栗子 🌰
姜	姜 🫚
豌豆	豌豆 🫛
豆荚	豆荚 🫛
豌豆荚	豌豆荚 🫛
面包	面包 🍞
牛角面包	牛角面包 🥐
新月形面包	新月形面包 🥐
羊角面包	羊角面包 🥐
法式长棍面包	法式长棍面包 🥖
长棍面包	长棍面包 🥖
长面包	长面包 🥖
面饼	面饼 🫓
大饼	大饼 🫓
饼	饼 🫓
椒盐卷饼	椒盐卷饼 🥨
百吉饼	百吉饼 🥯
百吉圈	百吉圈 🥯
面包圈	面包圈 🥯
烘焙	烘焙 🥯
煎饼	煎饼 🥞 🌯
薄煎饼	薄煎饼 🥞
烙饼	烙饼 🥞
蛋饼	蛋饼 🥞
华夫饼	华夫饼 🧇
格子饼	格子饼 🧇
奶酪	奶酪 🧀
芝士	芝士 🧀
起司	起司 🧀
肉	肉 🍖 🥩
带骨肉	带骨肉 🍖
排骨	排骨 🍖
吃肉	吃肉 🍖
家禽腿	家禽腿 🍗
家禽的腿	家禽的腿 🍗
鸡腿	鸡腿 🍗
鸡腿儿	鸡腿儿 🍗
肉排	肉排 🥩
牛排	牛排 🥩
猪排	猪排 🥩
羊排	羊排 🥩
培根	培根 🥓
烟肉	烟肉 🥓
汉堡	汉堡 🍔
汉堡包	汉堡包 🍔
薯条	薯条 🍟
比萨	比萨 🍕
比萨饼	比萨饼 🍕
吃比萨	吃比萨 🍕
吃比萨饼	吃比萨饼 🍕
热狗	热狗 🌭
三明治	三明治 🥪
卷饼	卷饼 🌮 🌯
墨西哥卷饼	墨西哥卷饼 🌮 🌯
墨西哥薄饼卷	墨西哥薄饼卷 🌮
煎饼馃子	煎饼馃子 🌯
墨西哥粽	墨西哥粽 🫔
墨西哥粽子	墨西哥粽子 🫔
皮塔三明治	皮塔三明治 🥙
法拉费	法拉费 🧆
中东蔬菜球	中东蔬菜球 🧆
油炸鹰嘴豆饼	油炸鹰嘴豆饼 🧆
炸豆丸子	炸豆丸子 🧆
肉丸	肉丸 🧆
肉丸子	肉丸子 🧆
鸡蛋	鸡蛋 🥚
蛋	蛋 🥚
蛋蛋	蛋蛋 🥚
烹饪	烹饪 🍳
平底锅	平底锅 🍳
煎蛋	煎蛋 🍳
食物	食物 🥘 🍲
一锅食物	一锅食物 🥘 🍲
火锅	火锅 🥘 🍲
奶酪火锅	奶酪火锅 🫕
芝士火锅	芝士火锅 🫕
起司火锅	起司火锅 🫕
碗勺	碗勺 🥣
放着勺的碗	放着勺的碗 🥣
碗	碗 🥣
汤	汤 🥣
沙拉	沙拉 🥗
绿色沙拉	绿色沙拉 🥗
蔬菜沙拉	蔬菜沙拉 🥗
爆米花	爆米花 🍿
黄油	黄油 🧈
黄乳油	黄乳油 🧈
盐	盐 🧂
食盐	食盐 🧂
佐料瓶	佐料瓶 🧂
佐料	佐料 🧂
调味品	调味品 🧂
罐头	罐头 🥫
罐头食品	罐头食品 🥫
便当	便当 🍱
便当盒	便当盒 🍱
盒饭	盒饭 🍱
外卖	外卖 🍱 🥡
快餐	快餐 🍱
快餐盒	快餐盒 🍱
米饼	米饼 🍘
米果	米果 🍘
饭团	饭团 🍙
煮熟的饭	煮熟的饭 🍚
米饭	米饭 🍚
大米	大米 🍚
大米饭	大米饭 🍚
咖喱	咖喱 🍛
咖喱饭	咖喱饭 🍛
冒热气的碗	冒热气的碗 🍜
拉面	拉面 🍜
面条	面条 🍜
碗面	碗面 🍜
一碗面	一碗面 🍜
吃面	吃面 🍜
意大利面	意大利面 🍝
意大利面条	意大利面条 🍝
意粉	意粉 🍝
意面	意面 🍝
地瓜	地瓜 🍠
烤地瓜	烤地瓜 🍠
红薯	红薯 🍠
烤红薯	烤红薯 🍠
番薯	番薯 🍠
烤番薯	烤番薯 🍠
甘薯	甘薯 🍠
烤甘薯	烤甘薯 🍠
关东煮	关东煮 🍢
串串	串串 🍢
寿司	寿司 🍣
炸虾	炸虾 🍤
天妇罗	天妇罗 🍤
盘绕是炸鱼饼	盘绕是炸鱼饼 🍥
鱼饼	鱼饼 🍥
鱼板	鱼板 🍥
月饼	月饼 🥮
月团	月团 🥮
丰收饼	丰收饼 🥮
团圆饼	团圆饼 🥮
团子	团子 🍡
糯米团	糯米团 🍡
饺子	饺子 🥟
水饺	水饺 🥟
幸运饼干	幸运饼干 🥠
外卖盒	外卖盒 🥡
外卖包装	外卖包装 🥡
外卖桶	外卖桶 🥡
螃蟹	螃蟹 🦀
蟹	蟹 🦀
蟹老板	蟹老板 🦀
龙虾	龙虾 🦞
小龙虾	小龙虾 🦞
麻辣小龙虾	麻辣小龙虾 🦞
虾	虾 🦐
大虾	大虾 🦐
对虾	对虾 🦐
鱿鱼	鱿鱼 🦑
乌贼	乌贼 🦑
墨鱼	墨鱼 🦑
牡蛎	牡蛎 🦪
生蚝	生蚝 🦪
蚝蛎	蚝蛎 🦪
软冰淇淋	软冰淇淋 🍦
软冰激凌	软冰激凌 🍦
冰淇淋	冰淇淋 🍦 🍨
冰激凌	冰激凌 🍦 🍨
圆筒冰淇淋	圆筒冰淇淋 🍦
圆筒冰激凌	圆筒冰激凌 🍦
甜筒	甜筒 🍦
刨冰	刨冰 🍧
冰沙	冰沙 🍧
油炸面圈	油炸面圈 🍩
甜甜圈	甜甜圈 🍩
曲奇	曲奇 🍪
饼干	饼干 🍪
曲奇饼干	曲奇饼干 🍪
cookie	cookie 🍪
cookies	cookies 🍪
蛋糕	蛋糕 🎂 🍰
生日蛋糕	生日蛋糕 🎂
水果蛋糕	水果蛋糕 🍰
纸杯蛋糕	纸杯蛋糕 🧁
派	派 🥧
油酥点心	油酥点心 🥧
点心	点心 🥧
巧克力	巧克力 🍫
巧克力棒	巧克力棒 🍫
朱古力	朱古力 🍫
朱古力棒	朱古力棒 🍫
糖果	糖果 🍬
糖	糖 🍬
吃糖	吃糖 🍬
棒棒糖	棒棒糖 🍭
蛋奶糕	蛋奶糕 🍮
甜品	甜品 🍮
甜点	甜点 🍮
布丁	布丁 🍮
蜜罐	蜜罐 🍯
蜂蜜	蜂蜜 🍯
奶瓶	奶瓶 🍼
喝奶	喝奶 🍼
一杯奶	一杯奶 🥛
牛奶杯	牛奶杯 🥛
牛奶	牛奶 🥛
杯子	杯子 🥛
咖啡	咖啡 ☕
咖啡杯	咖啡杯 ☕
喝咖啡	喝咖啡 ☕
茶壶	茶壶 🫖
一壶茶	一壶茶 🫖
一壶	一壶 🫖
茶	茶 🍵
茶水	茶水 🍵
茶杯	茶杯 🍵
清酒	清酒 🍶
开香槟	开香槟 🍾
香槟	香槟 🍾
葡萄酒	葡萄酒 🍷
酒杯	酒杯 🍷
酒	酒 🍷
鸡尾酒	鸡尾酒 🍸
热带饮料	热带饮料 🍹
热带水果饮料	热带水果饮料 🍹
水果饮料	水果饮料 🍹
果饮	果饮 🍹
冷饮	冷饮 🍹
啤酒	啤酒 🍺
干杯	干杯 🍻 🥂
碰杯	碰杯 🍻 🥂
威士忌	威士忌 🥃
平底杯	平底杯 🥃
一杯酒	一杯酒 🥃
一杯	一杯 🥃
玻璃杯	玻璃杯 🥃
倾倒液体	倾倒液体 🫗
倾倒	倾倒 🫗
流出	流出 🫗
外带杯子	外带杯子 🥤
带吸管杯	带吸管杯 🥤
吸管杯	吸管杯 🥤
饮料	饮料 🥤
波霸奶茶	波霸奶茶 🧋
珍珠奶茶	珍珠奶茶 🧋
奶茶	奶茶 🧋
一杯奶茶	一杯奶茶 🧋
果汁盒	果汁盒 🧃
果汁	果汁 🧃
马黛茶	马黛茶 🧉
冰块	冰块 🧊
冰	冰 🧊
加冰	加冰 🧊
筷子	筷子 🥢
餐具	餐具 🍽
刀叉	刀叉 🍴
勺子	勺子 🥄
汤勺	汤勺 🥄
匙子	匙子 🥄
汤匙	汤匙 🥄
刀	刀 🔪
菜刀	菜刀 🔪
水果刀	水果刀 🔪
小刀	小刀 🔪
罐子	罐子 🫙
瓶子	瓶子 🫙
玻璃瓶	玻璃瓶 🫙
双耳瓶	双耳瓶 🏺
地球	地球 🌐 🌍 🌎 🌏
子午线	子午线 🌐
经纬线	经纬线 🌐
地球仪	地球仪 🌍 🌎 🌏
欧洲	欧洲 🌍
非洲	非洲 🌍
欧洲非洲	欧洲非洲 🌍
非洲欧洲	非洲欧洲 🌍
欧洲地球仪	欧洲地球仪 🌍
非洲地球仪	非洲地球仪 🌍
欧洲非洲地球仪	欧洲非洲地球仪 🌍
欧非地球仪	欧非地球仪 🌍
美洲	美洲 🌎
美洲地球仪	美洲地球仪 🌎
亚洲	亚洲 🌏
澳洲	澳洲 🌏 🇦🇺
亚洲澳洲	亚洲澳洲 🌏
澳洲亚洲	澳洲亚洲 🌏
亚洲地球仪	亚洲地球仪 🌏
澳洲地球仪	澳洲地球仪 🌏
亚澳地球仪	亚澳地球仪 🌏
澳亚地球仪	澳亚地球仪 🌏
世界地图	世界地图 🗺
日本剪影	日本剪影 🗾
日本地图	日本地图 🗾
指南针	指南针 🧭
指北针	指北针 🧭
方向	方向 🧭
罗盘	罗盘 🧭
雪山	雪山 🏔
高山	高山 🏔
山脉	山脉 ⛰️
山	山 ⛰️
山峰	山峰 ⛰️
火山	火山 🌋
火山喷发	火山喷发 🌋
火山爆发	火山爆发 🌋
富士山	富士山 🗻
露营	露营 🏕
野营	野营 🏕
太阳伞	太阳伞 🏖
沙滩伞	沙滩伞 🏖 ⛱️
度假	度假 🏖
沙漠	沙漠 🏜
荒漠	荒漠 🏜
荒岛	荒岛 🏝
无人岛	无人岛 🏝
无人荒岛	无人荒岛 🏝
国家公园	国家公园 🏞
体育场	体育场 🏟
体育馆	体育馆 🏟
足球场	足球场 🏟
古典建筑	古典建筑 🏛
古建筑	古建筑 🏛
博物馆	博物馆 🏛
建筑施工	建筑施工 🏗
施工	施工 🏗 🚧
起重机	起重机 🏗
砖块	砖块 🧱
板砖	板砖 🧱
板儿砖	板儿砖 🧱
砖头	砖头 🧱
岩石	岩石 🪨
石头	石头 🪨
木头	木头 🪵
原木	原木 🪵
木材	木材 🪵
小屋	小屋 🛖
蒙古包	蒙古包 🛖
草屋	草屋 🛖
房屋群	房屋群 🏘
居民区	居民区 🏘
废弃的房屋	废弃的房屋 🏚
荒宅	荒宅 🏚
危楼	危楼 🏚
家	家 🏠
住宅楼	住宅楼 🏠
房子	房子 🏠
房屋	房屋 🏠
带花园的楼房	带花园的楼房 🏡
别墅	别墅 🏡
办公楼	办公楼 🏢
写字楼	写字楼 🏢
日本邮局	日本邮局 🏣
邮局	邮局 🏣 🏤
欧洲邮局	欧洲邮局 🏤
医院	医院 🏥
银行	银行 🏦
酒店	酒店 🏨
旅店	旅店 🏨
旅馆	旅馆 🏨
宾馆	宾馆 🏨
爱情酒店	爱情酒店 🏩
爱情旅店	爱情旅店 🏩
爱情旅馆	爱情旅馆 🏩
爱情宾馆	爱情宾馆 🏩
情侣酒店	情侣酒店 🏩
情侣旅店	情侣旅店 🏩
情侣旅馆	情侣旅馆 🏩
情侣宾馆	情侣宾馆 🏩
情人酒店	情人酒店 🏩
情人旅店	情人旅店 🏩
情人旅馆	情人旅馆 🏩
情人宾馆	情人宾馆 🏩
便利商店	便利商店 🏪
便利店	便利店 🏪
商店	商店 🏪
学校	学校 🏫
教学楼	教学楼 🏫
百货商店	百货商店 🏬
商场	商场 🏬
超市	超市 🏬
商超	商超 🏬
工厂	工厂 🏭
日本城堡	日本城堡 🏯
日式城堡	日式城堡 🏯
城堡	城堡 🏯 🏰
欧洲城堡	欧洲城堡 🏰
欧式城堡	欧式城堡 🏰
婚礼	婚礼 💒
教堂	教堂 💒 ⛪
东京塔	东京塔 🗼
自由女神像	自由女神像 🗽
自由女神	自由女神 🗽
圣堂	圣堂 ⛪
清真寺	清真寺 🕌
清真	清真 🕌
印度庙	印度庙 🛕
印度寺庙	印度寺庙 🛕
佛寺	佛寺 🛕
庙宇	庙宇 🛕
犹太教会堂	犹太教会堂 🕍
犹太教堂	犹太教堂 🕍
神社	神社 ⛩
日本神社	日本神社 ⛩
克尔白	克尔白 🕋
喷泉	喷泉 ⛲
公园	公园 ⛲
帐篷	帐篷 ⛺
雾气笼罩的桥	雾气笼罩的桥 🌁
雾蒙蒙	雾蒙蒙 🌁
雾气	雾气 🌁
星光闪闪的夜晚	星光闪闪的夜晚 🌃
夜晚	夜晚 🌃
晚上	晚上 🌃
半夜	半夜 🌃
深夜	深夜 🌃
城市景观	城市景观 🏙
城市风光	城市风光 🏙
都市景观	都市景观 🏙
都市风光	都市风光 🏙
城市	城市 🏙
都市	都市 🏙
大山日出	大山日出 🌄
山顶日出	山顶日出 🌄
山中日出	山中日出 🌄
日出	日出 🌄 🌅
旭日	旭日 🌄 🌅
旭日东升	旭日东升 🌄 🌅
暮色中的城市	暮色中的城市 🌆
暮色	暮色 🌆
黄昏	黄昏 🌆
傍晚	傍晚 🌆
大厦夕阳	大厦夕阳 🌇
夕阳	夕阳 🌇
日落	日落 🌇
落日	落日 🌇
夜间的大桥	夜间的大桥 🌉
夜间大桥	夜间大桥 🌉
夜幕下的桥	夜幕下的桥 🌉
大桥	大桥 🌉
温泉	温泉 ♨️
旋转木马	旋转木马 🎠
游乐园	游乐园 🎠
滑梯	滑梯 🛝
滑滑梯	滑滑梯 🛝
摩天轮	摩天轮 🎡
过山车	过山车 🎢
理发店招牌	理发店招牌 💈
理发店	理发店 💈
马戏	马戏 🎪
马戏团	马戏团 🎪
马戏团帐篷	马戏团帐篷 🎪
蒸汽火车	蒸汽火车 🚂
轨道车	轨道车 🚃
动车	动车 🚄 🚅
新干线	新干线 🚄 🚅
列车	列车 🚄 🚅
高速列车	高速列车 🚄 🚅
高铁	高铁 🚄 🚅
高速子弹头列车	高速子弹头列车 🚅
子弹头高速列车	子弹头高速列车 🚅
火车	火车 🚆
绿皮火车	绿皮火车 🚆
地铁	地铁 🚇 Ⓜ️
地下铁路	地下铁路 🚇
轻轨电车	轻轨电车 🚈
轻轨	轻轨 🚈
车站	车站 🚉
火车站	火车站 🚉
站台	站台 🚉
单轨铁路	单轨铁路 🚝
单轨	单轨 🚝
山区铁路	山区铁路 🚞
有轨电车	有轨电车 🚋
公交车	公交车 🚌 🚍
公共汽车	公共汽车 🚌 🚍
公车	公车 🚌 🚍
大巴	大巴 🚌 🚍
巴士	巴士 🚌 🚍
无轨电车	无轨电车 🚎
电车	电车 🚎
面包车	面包车 🚐
小巴	小巴 🚐
救护车	救护车 🚑
急救车	急救车 🚑
消防车	消防车 🚒
救火车	救火车 🚒
警车	警车 🚓 🚔
出租车	出租车 🚕 🚖
的士	的士 🚕 🚖
汽车	汽车 🚗 🚘
轿车	轿车 🚗 🚘
小汽车	小汽车 🚗 🚘
小轿车	小轿车 🚗 🚘
私家车	私家车 🚗 🚘
越野车	越野车 🚙
SUV	SUV 🚙
休闲车	休闲车 🚙
运动型多用途车	运动型多用途车 🚙
皮卡	皮卡 🛻
皮卡车	皮卡车 🛻
送货车	送货车 🚚
货车	货车 🚚
物流	物流 🚚
拖车	拖车 🚛
卡车	卡车 🚛
大卡车	大卡车 🚛
拖拉机	拖拉机 🚜
赛车	赛车 🏎
方程式赛车	方程式赛车 🏎
摩托	摩托 🏍
摩托车	摩托车 🏍
小型摩托车	小型摩托车 🛵
电动车	电动车 🛵
小电驴	小电驴 🛵
轮椅	轮椅 🦽 ♿
残疾人	残疾人 🦽
嘟嘟车	嘟嘟车 🛺
三蹦子	三蹦子 🛺
三脚鸡	三脚鸡 🛺
三轮车	三轮车 🛺
三轮摩托车	三轮摩托车 🛺
自动人力车	自动人力车 🛺
单车	单车 🚲
自行车	自行车 🚲
脚踏车	脚踏车 🚲
滑板车	滑板车 🛴
滑板	滑板 🛹
轮滑	轮滑 🛼
轮滑鞋	轮滑鞋 🛼
旱冰	旱冰 🛼
旱冰鞋	旱冰鞋 🛼
滑旱冰	滑旱冰 🛼
四轮滑冰鞋	四轮滑冰鞋 🛼
公交站	公交站 🚏
公交车站	公交车站 🚏
公共汽车站	公共汽车站 🚏
高速公路	高速公路 🛣
高速	高速 🛣
公路	公路 🛣
铁轨	铁轨 🛤
油桶	油桶 🛢
加油站	加油站 ⛽
加油	加油 ⛽
石油	石油 ⛽
车轮	车轮 🛞
轮胎	轮胎 🛞
轮子	轮子 🛞
警车旋转灯	警车旋转灯 🚨
警灯	警灯 🚨
警车灯	警车灯 🚨
交通信号灯	交通信号灯 🚥 🚦
交通灯	交通灯 🚥 🚦
信号灯	信号灯 🚥 🚦
红绿灯	红绿灯 🚥 🚦
八边形	八边形 🛑
施工符号	施工符号 🚧
施工中	施工中 🚧
前方施工	前方施工 🚧
路障	路障 🚧
锚	锚 ⚓
船锚	船锚 ⚓
救生圈	救生圈 🛟
游泳圈	游泳圈 🛟
救生	救生 🛟
帆船	帆船 ⛵
独木舟	独木舟 🛶
快艇	快艇 🚤
赛艇	赛艇 🚤
客轮	客轮 🛳
客船	客船 🛳
轮渡	轮渡 ⛴
渡轮	渡轮 ⛴
渡船	渡船 ⛴
摩托艇	摩托艇 🛥
轮船	轮船 🚢
邮轮	邮轮 🚢
海运	海运 🚢
船	船 🚢
飞机	飞机 ✈️
小型飞机	小型飞机 🛩
飞机起飞	飞机起飞 🛫
航班起飞	航班起飞 🛫
起飞	起飞 🛫
飞机着陆	飞机着陆 🛬
航班降落	航班降落 🛬
降落	降落 🛬
着陆	着陆 🛬
降落伞	降落伞 🪂
跳伞	跳伞 🪂
座位	座位 💺
直升机	直升机 🚁
直升飞机	直升飞机 🚁
高架铁路	高架铁路 🚟
空中轨道列车	空中轨道列车 🚟
空轨	空轨 🚟
高山索道	高山索道 🚠
缆车	缆车 🚠 🚡
空中缆车	空中缆车 🚡
卫星	卫星 🛰
火箭	火箭 🚀
rocket	rocket 🚀
UFO	UFO 🛸
不明飞行物	不明飞行物 🛸
飞碟	飞碟 🛸
服务铃	服务铃 🛎
行李箱	行李箱 🧳
行李	行李 🧳
沙漏	沙漏 ⌛ ⏳
手表	手表 ⌚
闹钟	闹钟 ⏰
闹表	闹表 ⏰
秒表	秒表 ⏱
计时器	计时器 ⏱
定时器	定时器 ⏲
台钟	台钟 🕰
壁炉钟	壁炉钟 🕰
座钟	座钟 🕰
十二点	十二点 🕛
十二点钟	十二点钟 🕛
十二点半	十二点半 🕧
一点钟	一点钟 🕐
一点半	一点半 🕜
两点	两点 🕑
两点钟	两点钟 🕑
两点半	两点半 🕝
三点	三点 🕒
三点钟	三点钟 🕒
三点半	三点半 🕞
四点	四点 🕓
四点钟	四点钟 🕓
四点半	四点半 🕟
五点	五点 🕔
五点钟	五点钟 🕔
五点半	五点半 🕠
六点	六点 🕕
六点钟	六点钟 🕕
六点半	六点半 🕡
七点	七点 🕖
七点钟	七点钟 🕖
七点半	七点半 🕢
八点	八点 🕗
八点钟	八点钟 🕗
八点半	八点半 🕣
九点	九点 🕘
九点钟	九点钟 🕘
九点半	九点半 🕤
十点	十点 🕙
十点钟	十点钟 🕙
十点半	十点半 🕥
十一点	十一点 🕚
十一点钟	十一点钟 🕚
十一点半	十一点半 🕦
新月	新月 🌑 🌚
朔月	朔月 🌑 🌚
眉月	眉月 🌒 🌘
蛾眉月	蛾眉月 🌒 🌘
残月	残月 🌒 🌘
月食	月食 🌒 🌘
上弦月	上弦月 🌓 🌛
盈凸月	盈凸月 🌔
满月	满月 🌕 🌝
圆月	圆月 🌕 🌝
月球	月球 🌕
亏凸月	亏凸月 🌖
下弦月	下弦月 🌗 🌜
月牙	月牙 🌙
月亮	月亮 🌙
弯月	弯月 🌙
微笑的新月	微笑的新月 🌚
微笑的朔月	微笑的朔月 🌚
微笑的上弦月	微笑的上弦月 🌛
微笑的下弦月	微笑的下弦月 🌜
温度计	温度计 🌡
太阳	太阳 ☀️ 🌞
日	日 ☀️
晴天	晴天 ☀️
微笑的月亮	微笑的月亮 🌝
微笑的满月	微笑的满月 🌝
微笑的太阳	微笑的太阳 🌞
行星	行星 🪐
土星	土星 🪐
有环行星	有环行星 🪐
星球	星球 🪐
五角星	五角星 ⭐
星星	星星 ⭐ 🌟 ✨
闪耀的星星	闪耀的星星 🌟
闪亮的星星	闪亮的星星 🌟
流星	流星 🌠
许愿	许愿 🌠
星空	星空 🌌
银河	银河 🌌
银河系	银河系 🌌
云	云 ☁️
云彩	云彩 ☁️
云朵	云朵 ☁️
cloud	cloud ☁️
天气	天气 ☁️
乌云蔽日	乌云蔽日 ⛅
多云	多云 ⛅
阴天	阴天 ⛅
雷阵雨	雷阵雨 ⛈️
大雨	大雨 ⛈️
下大雨	下大雨 ⛈️
少云	少云 🌤
晴偶有云	晴偶有云 🌤
白日小云	白日小云 🌤
下雨	下雨 🌧
雨	雨 🌧
雨云	雨云 🌧
下雪	下雪 🌨 ❄️
雪云	雪云 🌨
打雷	打雷 🌩
雷云	雷云 🌩
龙卷风	龙卷风 🌪
雾	雾 🌫
霾	霾 🌫
雾霾	雾霾 🌫
风吹拂的脸	风吹拂的脸 🌬
风吹拂	风吹拂 🌬
吹拂	吹拂 🌬
吹风	吹风 🌬
吹口气	吹口气 🌬
台风	台风 🌀
旋风	旋风 🌀
飓风	飓风 🌀
漩涡	漩涡 🌀
蚊香	蚊香 🌀
气旋	气旋 🌀
彩虹	彩虹 🌈
收起的伞	收起的伞 🌂
收起的雨伞	收起的雨伞 🌂
雨伞	雨伞 🌂 ☂️ ☔
打伞	打伞 ☂️ ☔
撑伞	撑伞 ☂️ ☔
伞状	伞状 ☂️
遮阳伞	遮阳伞 ⛱️
闪电	闪电 ⚡
高压电	高压电 ⚡
雪	雪 ❄️
雪花	雪花 ❄️
雪人	雪人 ⛄
堆雪人	堆雪人 ⛄
彗星	彗星 ☄️
哈雷	哈雷 ☄️
哈雷彗星	哈雷彗星 ☄️
火	火 🔥
火焰	火焰 🔥
燃烧	燃烧 🔥
点燃	点燃 🔥
着火	着火 🔥
着火了	着火了 🔥
火了	火了 🔥
汗滴	汗滴 💧
一滴水	一滴水 💧
一滴	一滴 💧
波浪	波浪 🌊
浪花	浪花 🌊
浪	浪 🌊
大浪	大浪 🌊
万圣节	万圣节 🎃
南瓜灯	南瓜灯 🎃
南瓜头	南瓜头 🎃
圣诞树	圣诞树 🎄
烟花	烟花 🎆 🎇
焰火	焰火 🎆 🎇
礼花	礼花 🎆 🎇
鞭炮	鞭炮 🧨
炸药	炸药 🧨
爆竹	爆竹 🧨
闪亮	闪亮 ✨
闪光	闪光 ✨
闪耀	闪耀 ✨
气球	气球 🎈
庆典	庆典 🎈
恭喜	恭喜 🎉
祝贺	祝贺 🎉
礼宾花	礼宾花 🎉
派对礼宾花	派对礼宾花 🎉
五彩纸屑球	五彩纸屑球 🎊
彩色碎纸	彩色碎纸 🎊
碎花彩球	碎花彩球 🎊
糖果球	糖果球 🎊
七夕	七夕 🎋
七夕树	七夕树 🎋
七夕节	七夕节 🎋
门松	门松 🎍
日本娃娃	日本娃娃 🎎
日本人形	日本人形 🎎
日本人偶	日本人偶 🎎
鲤鱼旗	鲤鱼旗 🎏
风铃	风铃 🎐
中秋	中秋 🎑
中秋节	中秋节 🎑
中秋佳节	中秋佳节 🎑
观月	观月 🎑
赏月	赏月 🎑
红包	红包 🧧
发红包	发红包 🧧
蝴蝶结	蝴蝶结 🎀
礼物	礼物 🎁
礼品	礼品 🎁
礼物盒	礼物盒 🎁
礼品盒	礼品盒 🎁
包装	包装 🎁
包装盒	包装盒 🎁
丝带	丝带 🎗
黄丝带	黄丝带 🎗
入场券	入场券 🎟
门票	门票 🎫
鞠躬勋章	鞠躬勋章 🎖
军功章	军功章 🎖
勋章	勋章 🎖
奖杯	奖杯 🏆
冠军	冠军 🏆
运动会奖牌	运动会奖牌 🏅
奖牌	奖牌 🏅
金牌	金牌 🥇
银牌	银牌 🥈
铜牌	铜牌 🥉
足球	足球 ⚽
英式足球	英式足球 ⚽
棒球	棒球 ⚾
垒球	垒球 🥎
篮球	篮球 🏀
排球	排球 🏐
橄榄球	橄榄球 🏈 🏉
美式橄榄球	美式橄榄球 🏈
英式橄榄球	英式橄榄球 🏉
网球	网球 🎾
飞盘	飞盘 🥏
保龄球	保龄球 🎳
保龄球瓶	保龄球瓶 🎳
板球	板球 🏏
板球拍	板球拍 🏏
曲棍球	曲棍球 🏑
冰球	冰球 🏒
袋棍球	袋棍球 🥍
乒乓球	乒乓球 🏓
乒乓球拍	乒乓球拍 🏓
羽毛球	羽毛球 🏸
羽毛球拍	羽毛球拍 🏸
球拍	球拍 🏸
拳击手套	拳击手套 🥊
武术服	武术服 🥋
空手道服	空手道服 🥋
跆拳道服	跆拳道服 🥋
柔道服	柔道服 🥋
球门网	球门网 🥅
球网	球网 🥅
球门	球门 🥅
高尔夫球洞	高尔夫球洞 ⛳
溜冰鞋	溜冰鞋 ⛸
溜冰	溜冰 ⛸
滑冰	滑冰 ⛸
钓鱼竿	钓鱼竿 🎣
渔竿	渔竿 🎣
钓竿	钓竿 🎣
钓鱼	钓鱼 🎣
潜水面罩	潜水面罩 🤿
深潜	深潜 🤿
潜水	潜水 🤿
运动背心	运动背心 🎽
滑雪橇	滑雪橇 🎿
滑雪装备	滑雪装备 🎿
雪橇	雪橇 🛷
乘雪橇	乘雪橇 🛷
驾雪橇	驾雪橇 🛷
坐雪橇	坐雪橇 🛷
冰上溜石	冰上溜石 🥌
溜石	溜石 🥌
冰壶	冰壶 🥌
靶心	靶心 🎯
正中靶心的飞镖	正中靶心的飞镖 🎯
飞镖	飞镖 🎯
命中	命中 🎯
溜溜球	溜溜球 🪀
悠悠球	悠悠球 🪀
风筝	风筝 🪁
放风筝	放风筝 🪁
风鸢	风鸢 🪁
纸鸢	纸鸢 🪁
水枪	水枪 🔫
玩具枪	玩具枪 🔫
滋水枪	滋水枪 🔫
台球	台球 🎱
黑八	黑八 🎱
水晶球	水晶球 🔮
占卜	占卜 🔮
魔法棒	魔法棒 🪄
魔棒	魔棒 🪄
手柄	手柄 🎮
游戏手柄	游戏手柄 🎮
视频游戏手柄	视频游戏手柄 🎮
电子游戏手柄	电子游戏手柄 🎮
操控杆	操控杆 🕹
游戏操控杆	游戏操控杆 🕹
摇杆	摇杆 🕹
游戏摇杆	游戏摇杆 🕹
老虎机	老虎机 🎰
赌场	赌场 🎰
赌博	赌博 🎰 🎲
色子	色子 🎲
骰子	骰子 🎲
酒桌游戏	酒桌游戏 🎲
拼图	拼图 🧩
拼图块	拼图块 🧩
拼块	拼块 🧩
拼块儿	拼块儿 🧩
泰迪熊	泰迪熊 🧸
泰迪	泰迪 🧸
皮纳塔	皮纳塔 🪅
镜面球	镜面球 🪩
迪斯科	迪斯科 🪩
俄罗斯套娃	俄罗斯套娃 🪆
套娃	套娃 🪆
扑克	扑克 ♠️ ♥️ ♦️ ♣️ 🃏
黑桃	黑桃 ♠️
红桃	红桃 ♥️
爱	爱 ♥️
心	心 ♥️
红心	红心 ♥️
心形	心形 ♥️
方片	方片 ♦️
方板	方板 ♦️
梅花	梅花 ♣️
草花	草花 ♣️
国际象棋兵	国际象棋兵 ♟
国际象棋	国际象棋 ♟
大小王	大小王 🃏
大王	大王 🃏
小王	小王 🃏
小丑牌	小丑牌 🃏
鬼牌	鬼牌 🃏
joker	joker 🃏
红中	红中 🀄
中	中 🀄
麻将	麻将 🀄
花扑克牌	花扑克牌 🎴
扑克牌	扑克牌 🎴
表演艺术	表演艺术 🎭
面具	面具 🎭
带画框的图片	带画框的图片 🖼
带框的画	带框的画 🖼
画框	画框 🖼
一幅画	一幅画 🖼
画画	画画 🎨
调色板	调色板 🎨
调色盘	调色盘 🎨
艺术	艺术 🎨
线轴	线轴 🧵
针	针 🪡
绣花针	绣花针 🪡
缝纫针	缝纫针 🪡
线团	线团 🧶
毛线	毛线 🧶
纱线	纱线 🧶
毛线球	毛线球 🧶
绳子	绳子 🪢
绳结	绳结 🪢
打结	打结 🪢
眼镜	眼镜 👓
近视	近视 👓
近视眼	近视眼 👓
护目镜	护目镜 🥽
泳镜	泳镜 🥽
游泳镜	游泳镜 🥽
实验室外衣	实验室外衣 🥼
白大褂	白大褂 🥼
白大褂儿	白大褂儿 🥼
安全背心	安全背心 🦺
救生衣	救生衣 🦺
衬衫领带	衬衫领带 👔
领带	领带 👔
衣服	衣服 👔
衬衫	衬衫 👕
恤衫	恤衫 👕
短袖	短袖 👕
上衣	上衣 👕
T恤	T恤 👕
T恤衫	T恤衫 👕
男衬衫	男衬衫 👕
男士衬衫	男士衬衫 👕
牛仔裤	牛仔裤 👖
裤子	裤子 👖
围巾	围巾 🧣
手套	手套 🧤
外套	外套 🧥
夹克	夹克 🧥
夹克衫	夹克衫 🧥
袜子	袜子 🧦
短袜	短袜 🧦
连衣裙	连衣裙 👗
长裙	长裙 👗
裙子	裙子 👗
和服	和服 👘
浴衣	浴衣 👘
纱丽	纱丽 🥻
连体泳衣	连体泳衣 🩱
泳衣	泳衣 🩱
泳装	泳装 🩱 👙
三角裤	三角裤 🩲
内裤	内裤 🩲
四角裤	四角裤 🩳
短裤	短裤 🩳
三点式	三点式 👙
比基尼	比基尼 👙
内衣	内衣 👙
女装	女装 👚
女士衬衫	女士衬衫 👚
女衬衫	女衬衫 👚
扇子	扇子 🪭
折扇	折扇 🪭
钱包	钱包 👛
零钱包	零钱包 👛
女士钱包	女士钱包 👛
手提包	手提包 👜
挎包	挎包 👜
女包	女包 👜
包包	包包 👜
手拿包	手拿包 👝
荷包	荷包 👝
皮包	皮包 👝
购物袋	购物袋 🛍
书包	书包 🎒
双肩包	双肩包 🎒
背包	背包 🎒
背囊	背囊 🎒
凉鞋	凉鞋 🩴 👡
夹趾凉鞋	夹趾凉鞋 🩴
沙滩凉鞋	沙滩凉鞋 🩴
拖鞋	拖鞋 🩴
人字拖	人字拖 🩴
皮鞋	皮鞋 👞
男鞋	男鞋 👞
网球鞋	网球鞋 👟
跑鞋	跑鞋 👟
运动鞋	运动鞋 👟
板鞋	板鞋 👟
板儿鞋	板儿鞋 👟
休闲鞋	休闲鞋 👟
鞋子	鞋子 👟
登山鞋	登山鞋 🥾
平底鞋	平底鞋 🥿
高跟鞋	高跟鞋 👠
高跟儿	高跟儿 👠
高跟儿鞋	高跟儿鞋 👠
女鞋	女鞋 👠
女式凉鞋	女式凉鞋 👡
高跟凉鞋	高跟凉鞋 👡
高跟儿凉鞋	高跟儿凉鞋 👡
芭蕾舞鞋	芭蕾舞鞋 🩰
足尖鞋	足尖鞋 🩰
高跟靴	高跟靴 👢
高跟儿靴	高跟儿靴 👢
女靴	女靴 👢
靴子	靴子 👢
长靴	长靴 👢
叉梳	叉梳 🪮
梳子	梳子 🪮
王冠	王冠 👑
皇冠	皇冠 👑
皇族	皇族 👑
带蝴蝶结的帽子	带蝴蝶结的帽子 👒
女帽	女帽 👒
宽檐帽	宽檐帽 👒
帽子	帽子 🎩
礼帽	礼帽 🎩
高帽	高帽 🎩
四方帽	四方帽 🎓
毕业帽	毕业帽 🎓
学士帽	学士帽 🎓
棒球帽	棒球帽 🧢
鸭舌帽	鸭舌帽 🧢
军用头盔	军用头盔 🪖
头盔	头盔 🪖
军人	军人 🪖
军盔	军盔 🪖
安全帽	安全帽 ⛑️
白十字头盔	白十字头盔 ⛑️
白十字安全帽	白十字安全帽 ⛑️
十字安全帽	十字安全帽 ⛑️
十字头盔	十字头盔 ⛑️
念珠	念珠 📿
口红	口红 💄
唇膏	唇膏 💄
戒指	戒指 💍
钻戒	钻戒 💍
求婚戒	求婚戒 💍
订婚戒	订婚戒 💍
星钻	星钻 💍
宝石	宝石 💎
钻石	钻石 💎
已静音的扬声器	已静音的扬声器 🔇
扬声器关闭	扬声器关闭 🔇
静音	静音 🔇
扬声器	扬声器 🔈 🔉 🔊
中等音量	中等音量 🔉
中等音量的扬声器	中等音量的扬声器 🔉
大音量	大音量 🔊
高音量	高音量 🔊
高音量的扬声器	高音量的扬声器 🔊
公共广播	公共广播 📢
喇叭	喇叭 📢 📣
喇叭筒	喇叭筒 📣
大喇叭	大喇叭 📣
邮政喇叭	邮政喇叭 📯
铃铛	铃铛 🔔
静音铃铛	静音铃铛 🔕
响铃关闭	响铃关闭 🔕
禁止响铃	禁止响铃 🔕
乐谱	乐谱 🎼
五线谱	五线谱 🎼
音符	音符 🎵 🎶
音乐	音乐 🎵 🎶
麦克风	麦克风 🎙 🎤
录音室麦克风	录音室麦克风 🎙
录音麦克风	录音麦克风 🎙
电平滑块	电平滑块 🎚
滑块	滑块 🎚
控制旋钮	控制旋钮 🎛
旋钮	旋钮 🎛
头戴式耳机	头戴式耳机 🎧
耳机	耳机 🎧
收音机	收音机 📻
无线电	无线电 📻
电台	电台 📻
萨克斯	萨克斯 🎷
萨克斯风	萨克斯风 🎷
萨克斯管	萨克斯管 🎷
管弦乐器	管弦乐器 🎷
手风琴	手风琴 🪗
吉他	吉他 🎸
电吉他	电吉他 🎸
音乐键盘	音乐键盘 🎹
钢琴	钢琴 🎹
钢琴按键	钢琴按键 🎹
钢琴键	钢琴键 🎹
琴键	琴键 🎹
小号	小号 🎺
小提琴	小提琴 🎻
提琴	提琴 🎻
班卓琴	班卓琴 🪕
鼓	鼓 🥁
打鼓	打鼓 🥁
敲鼓	敲鼓 🥁
长鼓	长鼓 🪘
康加鼓	康加鼓 🪘
沙锤	沙锤 🪇
笛子	笛子 🪈
长笛	长笛 🪈
竖笛	竖笛 🪈
移动电话	移动电话 📱
手机	手机 📱
智能手机	智能手机 📱
来电	来电 📲
来电了	来电了 📲
电话	电话 ☎️
固定电话	固定电话 ☎️
固话	固话 ☎️
座机	座机 ☎️
电话听筒	电话听筒 📞
电话筒	电话筒 📞
传呼机	传呼机 📟
呼机	呼机 📟
寻呼机	寻呼机 📟
传真	传真 📠
传真机	传真机 📠
发传真	发传真 📠
电池	电池 🔋
电量	电量 🔋 🪫
电源	电源 🔋 🔌
蓄电池	蓄电池 🔋
低电量	低电量 🪫
电量低	电量低 🪫
电池不足	电池不足 🪫
插头	插头 🔌
电插头	电插头 🔌
电源插头	电源插头 🔌
笔记本电脑	笔记本电脑 💻
个人电脑	个人电脑 💻
手提电脑	手提电脑 💻
笔电	笔电 💻
台式电脑	台式电脑 🖥
电脑	电脑 🖥
显示器	显示器 🖥
显示屏	显示屏 🖥
计算机	计算机 🖥
打印机	打印机 🖨
印刷机	印刷机 🖨
键盘	键盘 ⌨️
电脑键盘	电脑键盘 ⌨️
电脑鼠标	电脑鼠标 🖱
鼠标	鼠标 🖱
轨迹球	轨迹球 🖲
光盘	光盘 💽
光碟	光碟 💽
迷你光盘	迷你光盘 💽
迷你光碟	迷你光碟 💽
电脑光盘	电脑光盘 💽
软盘	软盘 💾
CD	CD 💿
DVD	DVD 📀
算盘	算盘 🧮
打算盘	打算盘 🧮
摄像机	摄像机 🎥 📹
摄录机	摄录机 🎥
摄影机	摄影机 🎥
电影摄影机	电影摄影机 🎥
电影胶片	电影胶片 🎞
胶卷	胶卷 🎞
胶片	胶片 🎞
电影	电影 🎞
菲林	菲林 🎞
电影放映机	电影放映机 📽
放映机	放映机 📽
上映	上映 📽
场记	场记 🎬
场记板	场记板 🎬
打板	打板 🎬
拍电影	拍电影 🎬
action	action 🎬
电视	电视 📺
电视机	电视机 📺
TV	TV 📺
相机	相机 📷
卡片相机	卡片相机 📷
照相机	照相机 📷
开闪光灯的相机	开闪光灯的相机 📸
拍照	拍照 📸
闪光灯	闪光灯 📸
闪光灯打开	闪光灯打开 📸
录像带	录像带 📼
录影带	录影带 📼
磁带	磁带 📼
放大镜	放大镜 🔍 🔎
蜡烛	蜡烛 🕯
烛光	烛光 🕯
烛火	烛火 🕯
灯泡	灯泡 💡
电灯泡	电灯泡 💡
白炽灯	白炽灯 💡
灯	灯 💡
电灯	电灯 💡
手电	手电 🔦
手电筒	手电筒 🔦
电筒	电筒 🔦
照明	照明 🔦
居酒屋灯笼	居酒屋灯笼 🏮
居酒屋	居酒屋 🏮
灯笼	灯笼 🏮
红灯笼	红灯笼 🏮
油灯	油灯 🪔
笔记本	笔记本 📔 📓 📒
记事本	记事本 📔 📓 📒
日记本	日记本 📔 📓 📒
红色的书	红色的书 📕
红色书本	红色书本 📕
小红书	小红书 📕
第一卷	第一卷 📕
书	书 📖 📚
图书	图书 📖 📚
书本	书本 📖 📚
书籍	书籍 📖 📚
打开的书	打开的书 📖
打开的书本	打开的书本 📖
绿色的书	绿色的书 📗
绿色书本	绿色书本 📗
教科书	教科书 📗
第二卷	第二卷 📗
蓝色的书	蓝色的书 📘
蓝色书本	蓝色书本 📘
第三卷	第三卷 📘
橙色的书	橙色的书 📙
橙色书本	橙色书本 📙
橘色的书	橘色的书 📙
橘色书本	橘色书本 📙
第四卷	第四卷 📙
账簿	账簿 📒
带卷边的纸	带卷边的纸 📃
卷边的纸	卷边的纸 📃
卷轴	卷轴 📜
纸	纸 📄
文书	文书 📄
文件	文件 📄
报纸	报纸 📰
新闻	新闻 📰
卷起的报纸	卷起的报纸 🗞
报纸卷	报纸卷 🗞
书签标签	书签标签 📑
标签页	标签页 📑
页签	页签 📑
书签	书签 🔖
标签	标签 🏷
吊牌	吊牌 🏷
钱	钱 💰
金钱	金钱 💰 💲
钱袋	钱袋 💰
工资	工资 💰
奖金	奖金 💰
money	money 💰
硬币	硬币 🪙
钢镚	钢镚 🪙
钢镚儿	钢镚儿 🪙
钱币	钱币 🪙
日元钞票	日元钞票 💴
美元钞票	美元钞票 💵
钞票	钞票 💵
纸币	纸币 💵
欧元钞票	欧元钞票 💶
英镑钞票	英镑钞票 💷
长翅膀的钱	长翅膀的钱 💸
长了翅膀的钱	长了翅膀的钱 💸
翅膀钱	翅膀钱 💸
花钱	花钱 💸
信用卡	信用卡 💳
借记卡	借记卡 💳
贷记卡	贷记卡 💳
银行卡	银行卡 💳
凭据	凭据 🧾
发票	发票 🧾
收据	收据 🧾
账单	账单 🧾
信件	信件 ✉️
信封	信封 ✉️
写信	写信 ✉️
电子邮件	电子邮件 📧
邮件	邮件 📧
来信	来信 📨
收到来信	收到来信 📨
收到邮件	收到邮件 📨 📥
新邮件	新邮件 📨
发件	发件 📤
发件箱	发件箱 📤
发信	发信 📤
发邮件	发邮件 📤
收件	收件 📥
收件箱	收件箱 📥
收信	收信 📥
收邮件	收邮件 📥
包裹	包裹 📦
快递	快递 📦
纸箱	纸箱 📦
纸箱子	纸箱子 📦
箱子	箱子 📦
打包	打包 📦
信箱	信箱 📪
邮筒	邮筒 📮
邮箱	邮箱 📮
投票	投票 🗳
投票箱	投票箱 🗳
选票	选票 🗳
铅笔	铅笔 ✏️
钢笔	钢笔 ✒️ 🖋
圆珠笔	圆珠笔 🖊
画笔	画笔 🖌
蜡笔	蜡笔 🖍
备忘录	备忘录 📝
便笺	便笺 📝
公文包	公文包 💼
公事包	公事包 💼
文件夹	文件夹 📁 📂
卡片索引分隔卡	卡片索引分隔卡 🗂
日历	日历 📅
手撕日历	手撕日历 📆
线圈笔记本	线圈笔记本 🗒
线圈本	线圈本 🗒
线圈日历	线圈日历 🗓
卡片索引	卡片索引 📇
卡牌索引	卡牌索引 📇
上升	上升 📈
上涨	上涨 📈
暴涨	暴涨 📈
下降	下降 📉
下跌	下跌 📉
暴跌	暴跌 📉
图表	图表 📊
条形图	条形图 📊
柱形图	柱形图 📊
柱状图	柱状图 📊
写字板	写字板 📋
剪贴板	剪贴板 📋
图钉	图钉 📌
圆图钉	圆图钉 📍
大头针	大头针 📍
回形针	回形针 📎 🖇
曲别针	曲别针 📎 🖇
直尺	直尺 📏
尺子	尺子 📏
三角尺	三角尺 📐
三角板	三角板 📐
剪刀	剪刀 ✂️
剪子	剪子 ✂️
卡片盒	卡片盒 🗃
卡片存档盒	卡片存档盒 🗃
文件柜	文件柜 🗄
废纸篓	废纸篓 🗑
垃圾桶	垃圾桶 🗑
垃圾篓	垃圾篓 🗑
垃圾	垃圾 🗑
锁	锁 🔒 🔓
合上的锁	合上的锁 🔒
门锁	门锁 🔒 🔓
锁头	锁头 🔒 🔓
上锁	上锁 🔒
锁上	锁上 🔒
锁住	锁住 🔒
打开的锁	打开的锁 🔓
解锁	解锁 🔓 🔐
开锁	开锁 🔓
带墨水笔的锁	带墨水笔的锁 🔏
隐秘	隐秘 🔏
已锁上但挂着钥匙的锁	已锁上但挂着钥匙的锁 🔐
密钥	密钥 🔐
钥匙	钥匙 🔑 🗝
古老的钥匙	古老的钥匙 🗝
老钥匙	老钥匙 🗝
旧钥匙	旧钥匙 🗝
老式钥匙	老式钥匙 🗝
复古钥匙	复古钥匙 🗝
锤子	锤子 🔨
铁锤	铁锤 🔨
斧子	斧子 🪓
斧头	斧头 🪓
铁镐	铁镐 ⛏️
锄头	锄头 ⛏️
鹤嘴锄	鹤嘴锄 ⛏️
锤子与镐	锤子与镐 ⚒️
锤子和镐	锤子和镐 ⚒️
锤子和扳手	锤子和扳手 🛠
锤子与扳手	锤子与扳手 🛠
锤子扳手	锤子扳手 🛠
工具	工具 🛠
匕首	匕首 🗡
短刀	短刀 🗡
短剑	短剑 🗡
双剑	双剑 ⚔️
双剑交叉	双剑交叉 ⚔️
战斗	战斗 ⚔️
开战	开战 ⚔️
开始战斗	开始战斗 ⚔️
fight	fight ⚔️
炸弹	炸弹 💣
boom	boom 💣
回旋镖	回旋镖 🪃
飞旋镖	飞旋镖 🪃
回力棒	回力棒 🪃
回力镖	回力镖 🪃
弓箭	弓箭 🏹
弓和箭	弓和箭 🏹
盾牌	盾牌 🛡
手锯	手锯 🪚
锯子	锯子 🪚
扳手	扳手 🔧
螺丝扳手	螺丝扳手 🔧
螺丝刀	螺丝刀 🪛
螺母及螺栓	螺母及螺栓 🔩
螺母与螺栓	螺母与螺栓 🔩
螺母和螺栓	螺母和螺栓 🔩
螺母螺栓	螺母螺栓 🔩
齿轮	齿轮 ⚙️
夹钳	夹钳 🗜
天平	天平 ⚖️
白手杖	白手杖 🦯
手杖	手杖 🦯
链接	链接 🔗
链条	链条 ⛓️
铁链	铁链 ⛓️
锁链	锁链 ⛓️
链子	链子 ⛓️
铁链子	铁链子 ⛓️
钩子	钩子 🪝
挂钩	挂钩 🪝
铁钩	铁钩 🪝
弯钩	弯钩 🪝
工具箱	工具箱 🧰
磁铁	磁铁 🧲
吸铁石	吸铁石 🧲
磁力	磁力 🧲
磁石	磁石 🧲
梯子	梯子 🪜
爬梯	爬梯 🪜
爬梯子	爬梯子 🪜
翻墙	翻墙 🪜
科学上网	科学上网 🪜
魔法上网	魔法上网 🪜
蒸馏器	蒸馏器 ⚗️
试管	试管 🧪
培养皿	培养皿 🧫
DNA	DNA 🧬
脱氧核糖核酸	脱氧核糖核酸 🧬
基因	基因 🧬
显微镜	显微镜 🔬
望远镜	望远镜 🔭
卫星天线	卫星天线 📡
天线	天线 📡
接收天线	接收天线 📡
注射器	注射器 💉
打针	打针 💉
血滴	血滴 🩸
滴血	滴血 🩸
药丸	药丸 💊
胶囊	胶囊 💊
创可贴	创可贴 🩹
拐杖	拐杖 🩼
听诊器	听诊器 🩺
X射线	X射线 🩻
X光	X光 🩻
X光片	X光片 🩻
拍片	拍片 🩻
胸透	胸透 🩻
胸片	胸片 🩻
门	门 🚪
房门	房门 🚪
门子	门子 🚪
电梯	电梯 🛗
升降机	升降机 🛗
镜子	镜子 🪞
魔镜	魔镜 🪞
窗户	窗户 🪟
床	床 🛏
沙发和灯	沙发和灯 🛋
沙发	沙发 🛋
椅子	椅子 🪑
凳子	凳子 🪑
马桶	马桶 🚽
马桶吸	马桶吸 🪠
搋子	搋子 🪠
马桶搋子	马桶搋子 🪠
水拔子	水拔子 🪠
皮老虎	皮老虎 🪠
马桶吸盘	马桶吸盘 🪠
马桶吸把	马桶吸把 🪠
马桶疏通器	马桶疏通器 🪠
通通乐	通通乐 🪠
马桶塞	马桶塞 🪠
马桶抽子	马桶抽子 🪠
淋浴	淋浴 🚿
喷头	喷头 🚿
浴缸	浴缸 🛁
捕鼠器	捕鼠器 🪤
剃刀	剃刀 🪒
剃须刀	剃须刀 🪒
刮胡刀	刮胡刀 🪒
手动刮胡刀	手动刮胡刀 🪒
乳液	乳液 🧴
乳液瓶	乳液瓶 🧴
护肤霜	护肤霜 🧴
洗发水	洗发水 🧴
沐浴露	沐浴露 🧴
洗发露	洗发露 🧴
安全别针	安全别针 🧷
别针	别针 🧷
扣针	扣针 🧷
扫帚	扫帚 🧹
扫把	扫把 🧹
笤帚	笤帚 🧹
篮子	篮子 🧺
竹篮	竹篮 🧺
菜篮	菜篮 🧺
菜篮子	菜篮子 🧺
卫生纸	卫生纸 🧻
卷纸	卷纸 🧻
纸巾	纸巾 🧻
水桶	水桶 🪣
圆桶	圆桶 🪣
肥皂	肥皂 🧼
香皂	香皂 🧼
泡泡	泡泡 🫧
气泡	气泡 🫧
牙刷	牙刷 🪥
刷牙	刷牙 🪥
海绵	海绵 🧽
灭火器	灭火器 🧯
购物车	购物车 🛒
手推车	手推车 🛒
烟	烟 🚬
香烟	香烟 🚬
卷烟	卷烟 🚬
纸烟	纸烟 🚬
吸烟	吸烟 🚬
抽烟	抽烟 🚬
烤烟	烤烟 🚬
来一根	来一根 🚬
来一根儿	来一根儿 🚬
棺材	棺材 ⚰️
灵柩	灵柩 ⚰️
墓碑	墓碑 🪦
坟墓	坟墓 🪦
骨灰盒	骨灰盒 ⚱️
骨灰缸	骨灰缸 ⚱️
恶魔之眼	恶魔之眼 🧿
恶魔眼	恶魔眼 🧿
恶魔的眼	恶魔的眼 🧿
法蒂玛	法蒂玛 🪬
法蒂玛之手	法蒂玛之手 🪬
复活岛	复活岛 🗿
复活节岛	复活节岛 🗿
复活节岛石像	复活节岛石像 🗿
摩艾石像	摩艾石像 🗿
标语	标语 🪧
布告	布告 🪧
布告牌	布告牌 🪧
标语牌	标语牌 🪧
身份证	身份证 🪪 🆔
ID	ID 🪪 🆔
驾照	驾照 🪪
执照	执照 🪪
证件	证件 🪪
证照	证照 🪪
ATM	ATM 🏧
取款机	取款机 🏧
提款机	提款机 🏧
垃圾入篓标志	垃圾入篓标志 🚮
垃圾入篓	垃圾入篓 🚮
垃圾丢弃处	垃圾丢弃处 🚮
丢垃圾	丢垃圾 🚮
扔垃圾	扔垃圾 🚮
倒垃圾	倒垃圾 🚮
水龙头	水龙头 🚰
饮用水	饮用水 🚰
直饮水	直饮水 🚰
饮水处	饮水处 🚰
轮椅标志	轮椅标志 ♿
男士标志	男士标志 🚹
男士符号	男士符号 🚹
男士	男士 🚹
男厕	男厕 🚹
男厕所	男厕所 🚹
男洗手间	男洗手间 🚹
女士标志	女士标志 🚺
女士符号	女士符号 🚺
女士	女士 🚺
女厕	女厕 🚺
女厕所	女厕所 🚺
女洗手间	女洗手间 🚺
WC	WC 🚻
卫生间	卫生间 🚻 🚾
厕所	厕所 🚻 🚾
洗手间	洗手间 🚻 🚾
盥洗室	盥洗室 🚻 🚾
婴儿符号	婴儿符号 🚼
婴儿标志	婴儿标志 🚼
护照检查处	护照检查处 🛂
安检	安检 🛂
护照检查	护照检查 🛂
检查护照	检查护照 🛂
海关	海关 🛃
海关检查	海关检查 🛃
行李领取处	行李领取处 🛄
行李领取	行李领取 🛄
领取行李	领取行李 🛄
行李寄存处	行李寄存处 🛅
行李寄存	行李寄存 🛅
寄存行李	寄存行李 🛅
警告	警告 ⚠️
注意	注意 ⚠️
危险	危险 ⚠️
预警	预警 ⚠️
学童过街	学童过街 🚸
儿童过街	儿童过街 🚸
注意儿童	注意儿童 🚸
当心儿童	当心儿童 🚸
禁止驶入	禁止驶入 ⛔
禁止通行	禁止通行 ⛔
请勿入内	请勿入内 ⛔
请勿驶入	请勿驶入 ⛔
禁止	禁止 🚫 🈲
严禁	严禁 🚫 🈲
不准	不准 🚫
不许	不许 🚫
禁止骑车	禁止骑车 🚳
禁止骑行	禁止骑行 🚳
禁止自行车	禁止自行车 🚳
禁止吸烟	禁止吸烟 🚭
请勿吸烟	请勿吸烟 🚭
禁烟	禁烟 🚭
勿扔垃圾	勿扔垃圾 🚯
勿丢垃圾	勿丢垃圾 🚯
请勿乱丢垃圾	请勿乱丢垃圾 🚯
请勿乱扔垃圾	请勿乱扔垃圾 🚯
禁丢垃圾	禁丢垃圾 🚯
禁止扔垃圾	禁止扔垃圾 🚯
禁止丢垃圾	禁止丢垃圾 🚯
禁止乱扔垃圾	禁止乱扔垃圾 🚯
禁止乱丢垃圾	禁止乱丢垃圾 🚯
非饮用水	非饮用水 🚱
请勿饮用	请勿饮用 🚱
禁止行人	禁止行人 🚷
禁止行人通行	禁止行人通行 🚷
禁止使用手机	禁止使用手机 📵
禁止打电话	禁止打电话 📵
十八禁	十八禁 🔞
未成年	未成年 🔞
未成年不宜	未成年不宜 🔞
成人	成人 🔞
放射性	放射性 ☢️
辐射	辐射 ☢️
生物危害	生物危害 ☣️
生化危机	生化危机 ☣️
上	上 ⬆️ ↑
上箭头	上箭头 ⬆️ ↑
向上箭头	向上箭头 ⬆️
右上	右上 ↗️ ↗
右上箭头	右上箭头 ↗️ ↗
右	右 ➡️ →
右箭头	右箭头 ➡️ →
向右箭头	向右箭头 ➡️
右下	右下 ↘️ ↘
右下箭头	右下箭头 ↘️ ↘
下	下 ⬇️ ↓
下箭头	下箭头 ⬇️ ↓
向下箭头	向下箭头 ⬇️
左下	左下 ↙️ ↙
左下箭头	左下箭头 ↙️ ↙
左	左 ⬅️ ←
左箭头	左箭头 ⬅️ ←
向左箭头	向左箭头 ⬅️
左上	左上 ↖️ ↖
左上箭头	左上箭头 ↖️ ↖
上下	上下 ↕️ ↕
上下箭头	上下箭头 ↕️ ↕
左右	左右 ↔️ ↔︎
左右箭头	左右箭头 ↔️ ↔︎
回车	回车 ↩️
重新载入	重新载入 🔃
顺时针	顺时针 🔃
顺时针方向	顺时针方向 🔃
顺时针垂直箭头	顺时针垂直箭头 🔃
逆时针	逆时针 🔄
逆时针方向	逆时针方向 🔄
逆时针垂直箭头	逆时针垂直箭头 🔄
back	back 🔙
退回	退回 🔙
end	end 🔚
结束	结束 🔚
on	on 🔛
开启	开启 🔛
soon	soon 🔜
马上	马上 🔜
top	top 🔝
祷告	祷告 🛐
原子符号	原子符号 ⚛️
原子	原子 ⚛️
atom	atom ⚛️
奥姆	奥姆 🕉
奥姆符号	奥姆符号 🕉
大卫之星	大卫之星 ✡️
法轮	法轮 ☸️
太极	太极 ☯️
阴阳	阴阳 ☯️
十字架	十字架 ✝️
基督	基督 ✝️
基督教	基督教 ✝️
东正教	东正教 ☦️
东正教十字架	东正教十字架 ☦️
星月	星月 ☪️
和平	和平 ☮️
和平符号	和平符号 ☮️
和平标志	和平标志 ☮️
世界和平	世界和平 ☮️
peace	peace ☮️
光明节	光明节 🕎
六角星	六角星 🔯
六芒星	六芒星 🔯
魔法阵	魔法阵 🔯
锡克	锡克 🪯
锡克教	锡克教 🪯
坎达	坎达 🪯
坎达符号	坎达符号 🪯
白羊座	白羊座 ♈
金牛座	金牛座 ♉
双子座	双子座 ♊
巨蟹座	巨蟹座 ♋
狮子座	狮子座 ♌
处女座	处女座 ♍
天秤座	天秤座 ♎
天蝎座	天蝎座 ♏
射手座	射手座 ♐
摩羯座	摩羯座 ♑
水瓶座	水瓶座 ♒
双鱼座	双鱼座 ♓
蛇夫座	蛇夫座 ⛎
随机播放	随机播放 🔀
随机	随机 🔀
交叉箭头	交叉箭头 🔀
循环播放	循环播放 🔁
单曲循环	单曲循环 🔂
播放	播放 ▶️
开始	开始 ▶️
开始播放	开始播放 ▶️
快进	快进 ⏩
快进符号	快进符号 ⏩
下一首	下一首 ⏭️
播放暂停	播放暂停 ⏯️
倒退	倒退 ◀️
倒退按钮	倒退按钮 ◀️
快退	快退 ⏪
快退符号	快退符号 ⏪
上一首	上一首 ⏮️
上三角	上三角 🔼
调高	调高 🔼
快上	快上 ⏫
下三角	下三角 🔽
调低	调低 🔽
快下	快下 ⏬
暂停	暂停 ⏸️
停止	停止 ⏹️
录音	录音 ⏺️
录音按钮	录音按钮 ⏺️
开始录音	开始录音 ⏺️
录像	录像 ⏺️
录像按钮	录像按钮 ⏺️
开始录像	开始录像 ⏺️
弹出	弹出 ⏏️
推出	推出 ⏏️
弹出按钮	弹出按钮 ⏏️
推出按钮	推出按钮 ⏏️
电影院	电影院 🎦
亮度	亮度 🔅 🔆
亮度低	亮度低 🔅
低亮度	低亮度 🔅
亮度高	亮度高 🔆
高亮度	高亮度 🔆
信号强度条	信号强度条 📶
信号强度	信号强度 📶
信号	信号 📶
手机信号	手机信号 📶
wireless	wireless 🛜
WiFi	WiFi 🛜
Wi-Fi	Wi-Fi 🛜
无线局域网	无线局域网 🛜
无线网	无线网 🛜
无线网络	无线网络 🛜
网络	网络 🛜
震动	震动 📳
振动模式	振动模式 📳
关机	关机 📴
手机关机	手机关机 📴
关闭手机	关闭手机 📴
女	女 ♀
女性	女性 ♀
男	男 ♂
男性	男性 ♂
跨性别	跨性别 ⚧ 🏳️‍⚧️
跨性别符号	跨性别符号 ⚧
变性	变性 ⚧
乘	乘 ✖️
乘以	乘以 ✖️
乘号	乘号 ✖️
加	加 ➕
加号	加号 ➕
减	减 ➖
减号	减号 ➖
除	除 ➗
除以	除以 ➗
除号	除号 ➗
等于	等于 🟰
等号	等号 🟰
等于号	等于号 🟰
粗等号	粗等号 🟰
双感叹号	双感叹号 ‼️
双惊叹号	双惊叹号 ‼️
双叹号	双叹号 ‼️
俩叹号	俩叹号 ‼️
疑问惊叹号	疑问惊叹号 ⁉️
疑问惊叹	疑问惊叹 ⁉️
叹问号	叹问号 ⁉️
叹号问号	叹号问号 ⁉️
感叹号问号	感叹号问号 ⁉️
惊问	惊问 ⁉️
问号	问号 ❓ ❔
白色问号	白色问号 ❔
白问号	白问号 ❔
感叹号	感叹号 ❗ ❕
惊叹号	惊叹号 ❗ ❕
叹号	叹号 ❗ ❕
白色感叹号	白色感叹号 ❕
白色惊叹号	白色惊叹号 ❕
白色叹号	白色叹号 ❕
白感叹号	白感叹号 ❕
白惊叹号	白惊叹号 ❕
白叹号	白叹号 ❕
波浪型破折号	波浪型破折号 〰️
波浪线	波浪线 〰️
兑换	兑换 💱
外汇	外汇 💱
换汇	换汇 💱
汇率	汇率 💱
流通	流通 💱
货币兑换	货币兑换 💱
出国	出国 💱
粗美元符号	粗美元符号 💲
货币	货币 💲
价钱	价钱 💲
医疗标志	医疗标志 ⚕
医疗符号	医疗符号 ⚕
蛇杖	蛇杖 ⚕
阿斯克勒庇俄斯	阿斯克勒庇俄斯 ⚕
单蛇之杖	单蛇之杖 ⚕
环保	环保 ♻️
循环	循环 ♻️
循环再生	循环再生 ♻️
循环利用	循环利用 ♻️
回收	回收 ♻️
百合花饰	百合花饰 ⚜️
百合花	百合花 ⚜️
鸢尾花	鸢尾花 ⚜️
三叉戟	三叉戟 🔱
三叉戟标志	三叉戟标志 🔱
姓名牌	姓名牌 📛
日本新手驾驶标志	日本新手驾驶标志 🔰
日本初学者标志	日本初学者标志 🔰
对	对 ⭕ ✅ ✔
答对	答对 ⭕ ✅
答对了	答对了 ⭕ ✅
正确	正确 ⭕ ✅ ✔
圆圈	圆圈 ⭕
对号	对号 ✅ ✔
对钩	对钩 ✅ ✔
勾选	勾选 ✅ ✔
按钮	按钮 ☑️ 🔘
复选	复选 ☑️
复选框	复选框 ☑️
复选按钮	复选按钮 ☑️
打钩	打钩 ☑️
打对钩	打对钩 ☑️
错	错 ❌ ❎
答错	答错 ❌ ❎
答错了	答错了 ❌ ❎
错号	错号 ❌ ❎
错误	错误 ❌ ❎
叉	叉 ❌ ❎
叉叉	叉叉 ❌ ❎
画叉	画叉 ❌ ❎
卷曲环	卷曲环 ➰
双卷曲环	双卷曲环 ➿
歌记号	歌记号 〽️
八轮辐星号	八轮辐星号 ✳️
八角星	八角星 ✴️
版权	版权 ©
版权符号	版权符号 ©
Copyright	Copyright ©
注册	注册 ®
注册标记	注册标记 ®
注册商标符号	注册商标符号 ®
注册商标	注册商标 ®
Registered	Registered ®
商标	商标 ™
商标符号	商标符号 ™
TM	TM ™
井号	井号 #️⃣
井号键	井号键 #️⃣
星号	星号 *️⃣
星号键	星号键 *️⃣
零	零 0️⃣
一	一 1️⃣
二	二 2️⃣
三	三 3️⃣
四	四 4️⃣
五	五 5️⃣
六	六 6️⃣
七	七 7️⃣
八	八 8️⃣
九	九 9️⃣
十	十 🔟
ABCD	ABCD 🔠
英文	英文 🔠 🔡
英语	英语 🔠 🔡
拉丁文	拉丁文 🔠 🔡
大写	大写 🔠
英文大写	英文大写 🔠
大写字母	大写字母 🔠
abcd	abcd 🔡
小写	小写 🔡
英文小写	英文小写 🔡
小写字母	小写字母 🔡
数字	数字 🔢
一二三四	一二三四 🔢
符号	符号 🔣
字符	字符 🔣
abc	abc 🔤
血型	血型 🅰️ 🆎 🅱️ 🅾️
A	A 🅰️
A型	A型 🅰️
A型血	A型血 🅰️
A血型	A血型 🅰️
AB	AB 🆎
AB型	AB型 🆎
AB型血	AB型血 🆎
AB血型	AB血型 🆎
B	B 🅱️
B型	B型 🅱️
B型血	B型血 🅱️
B血型	B血型 🅱️
O	O 🅾️
O型	O型 🅾️
O型血	O型血 🅾️
O血型	O血型 🅾️
清除	清除 🆑
清理	清理 🆑
clear	clear 🆑
cool	cool 🆒
酷	酷 🆒
超酷	超酷 🆒
很酷	很酷 🆒
特别酷	特别酷 🆒
free	free 🆓
免费	免费 🆓
自由	自由 🆓
资讯	资讯 ℹ️
info	info ℹ️
information	information ℹ️
身份	身份 🆔
new	new 🆕
新	新 🆕
新的	新的 🆕
新建	新建 🆕
全新	全新 🆕
NG	NG 🆖
重拍	重拍 🆖
停车	停车 🅿️
停车场	停车场 🅿️
停车按钮	停车按钮 🅿️
泊车	泊车 🅿️
parking	parking 🅿️
SOS	SOS 🆘
求救信号	求救信号 🆘
求救讯号	求救讯号 🆘
救命	救命 🆘
救我	救我 🆘
救救我	救救我 🆘
求救	求救 🆘
up	up 🆙
顶	顶 🆙
升级	升级 🆙
Vs.	Vs. 🆚
比	比 🆚
对决	对决 🆚
对抗	对抗 🆚
对战	对战 🆚
比赛	比赛 🆚
这里	这里 🈁
服务费	服务费 🈂️
月	月 🈷️
有	有 🈶
有料	有料 🈶
收费	收费 🈶
指	指 🈯
得	得 🉐
讨价还价	讨价还价 🉐
割	割 🈹
打折	打折 🈹
无	无 🈚️
没有	没有 🈚️
禁	禁 🈲
可	可 🉑
申	申 🈸
申请	申请 🈸
合	合 🈴
合格	合格 🈴
空	空 🈳
空位	空位 🈳
祝	祝 ㊗️
祝福	祝福 ㊗️
秘	秘 ㊙️
营	营 🈺
营业	营业 🈺
开门营业	开门营业 🈺
满	满 🈵
满座	满座 🈵
满了	满了 🈵
没有空位	没有空位 🈵
红色	红色 🔴 🟥
橙色	橙色 🟠 🟧
橘色	橘色 🟠 🟧
橘黄色	橘黄色 🟠 🟧
黄色	黄色 🟡 🟨
绿色	绿色 🟢 🟩
蓝色	蓝色 🔵 🟦
紫色	紫色 🟣 🟪
棕色	棕色 🟤 🟫
圆形	圆形 ⚫ ⚪
围棋	围棋 ⚫ ⚪
黑白棋	黑白棋 ⚫ ⚪
黑色	黑色 ⚫ ⬛
黑子	黑子 ⚫
黑棋	黑棋 ⚫
黑点	黑点 ⚫
小黑点	小黑点 ⚫
小黑点儿	小黑点儿 ⚫
白色	白色 ⚪ ⬜
白子	白子 ⚪
白棋	白棋 ⚪
白点	白点 ⚪
小白点	小白点 ⚪
小白点儿	小白点儿 ⚪
元宵	元宵 ⚪
汤圆	汤圆 ⚪
雪球	雪球 ⚪
小圆点	小圆点 ⚪
小圆点儿	小圆点儿 ⚪
正方形	正方形 ⬛ ⬜
方块	方块 ⬛ ⬜
方形	方形 ⬛ ⬜
矩形	矩形 ⬛ ⬜
黑框	黑框 ⬛
小黑框	小黑框 ⬛
白框	白框 ⬜
小白框	小白框 ⬜
中方块	中方块 ◼ ◻
中正方形	中正方形 ◼ ◻
白色中方块	白色中方块 ◼
中等方块	中等方块 ◼ ◻
中等正方形	中等正方形 ◼ ◻
白色中等方块	白色中等方块 ◼
黑色中方块	黑色中方块 ◻
黑色中等方块	黑色中等方块 ◻
大方块	大方块 ◾ ◽
大正方形	大正方形 ◾ ◽
白色大方块	白色大方块 ◾
黑色大方块	黑色大方块 ◽
小方块	小方块 ▪ ▫
小正方形	小正方形 ▪ ▫
白色小方块	白色小方块 ▪
黑色小方块	黑色小方块 ▫
菱形	菱形 🔶 🔷
大菱形	大菱形 🔶 🔷
橙色菱形	橙色菱形 🔶
橘色菱形	橘色菱形 🔶
橘黄色菱形	橘黄色菱形 🔶
橙色大菱形	橙色大菱形 🔶
橘色大菱形	橘色大菱形 🔶
橘黄色大菱形	橘黄色大菱形 🔶
蓝色菱形	蓝色菱形 🔷
蓝色大菱形	蓝色大菱形 🔷
小方片	小方片 🔸 🔹
小菱形	小菱形 🔸 🔹
橙色小菱形	橙色小菱形 🔸
橘色小菱形	橘色小菱形 🔸
橘黄色小菱形	橘黄色小菱形 🔸
蓝色小菱形	蓝色小菱形 🔹
三角	三角 🔺 🔻
三角形	三角形 🔺 🔻
正三角	正三角 🔺
红色正三角	红色正三角 🔺
倒三角	倒三角 🔻
红色倒三角	红色倒三角 🔻
单选	单选 🔘
单选框	单选框 🔘
单选按钮	单选按钮 🔘
方形按钮	方形按钮 🔳 🔲
白线方形按钮	白线方形按钮 🔳
白线正方形按钮	白线正方形按钮 🔳
白色方形按钮	白色方形按钮 🔳
白色正方形按钮	白色正方形按钮 🔳
白边线方形按钮	白边线方形按钮 🔳
白边线正方形按钮	白边线正方形按钮 🔳
黑线方形按钮	黑线方形按钮 🔲
黑线正方形按钮	黑线正方形按钮 🔲
黑色方形按钮	黑色方形按钮 🔲
黑色正方形按钮	黑色正方形按钮 🔲
黑边线方形按钮	黑边线方形按钮 🔲
黑边线正方形按钮	黑边线正方形按钮 🔲
格子旗	格子旗 🏁
终点旗	终点旗 🏁
终点	终点 🏁
旗帜	旗帜 🚩
旗子	旗子 🚩
三角旗	三角旗 🚩
旗杆上的三角旗	旗杆上的三角旗 🚩
旗杆上的旗帜	旗杆上的旗帜 🚩
红色旗帜	红色旗帜 🚩
交叉旗	交叉旗 🎌
举黑旗	举黑旗 🏴
黑旗	黑旗 🏴
黑色旗	黑色旗 🏴
黑色旗子	黑色旗子 🏴
黑色旗帜	黑色旗帜 🏴
举白旗	举白旗 🏳
白旗	白旗 🏳
白色旗子	白色旗子 🏳
白色旗帜	白色旗帜 🏳
认输	认输 🏳
认输了	认输了 🏳
投降	投降 🏳
同性旗	同性旗 🏳️‍🌈
彩虹旗	彩虹旗 🏳️‍🌈
跨性别旗	跨性别旗 🏳️‍⚧️
海盗	海盗 🏴‍☠️
海盗旗	海盗旗 🏴‍☠️
海贼	海贼 🏴‍☠️
海贼旗	海贼旗 🏴‍☠️
阿森松岛	阿森松岛 🇦🇨
阿森松	阿森松 🇦🇨
安道尔	安道尔 🇦🇩
安道尔公国	安道尔公国 🇦🇩
阿拉伯联合酋长国	阿拉伯联合酋长国 🇦🇪
阿拉伯	阿拉伯 🇦🇪
阿富汗	阿富汗 🇦🇫
安提瓜和巴布达	安提瓜和巴布达 🇦🇬
安巴	安巴 🇦🇬
安圭拉	安圭拉 🇦🇮
阿尔巴尼亚	阿尔巴尼亚 🇦🇱
阿尔巴尼亚共和国	阿尔巴尼亚共和国 🇦🇱
亚美尼亚	亚美尼亚 🇦🇲
亚美尼亚共和国	亚美尼亚共和国 🇦🇲
安哥拉	安哥拉 🇦🇴
安哥拉共和国	安哥拉共和国 🇦🇴
南极洲	南极洲 🇦🇶
阿根廷	阿根廷 🇦🇷
阿根廷共和国	阿根廷共和国 🇦🇷
美属萨摩亚	美属萨摩亚 🇦🇸
东萨摩亚	东萨摩亚 🇦🇸
奥地利	奥地利 🇦🇹
奥地利共和国	奥地利共和国 🇦🇹
澳大利亚	澳大利亚 🇦🇺
澳大利亚联邦	澳大利亚联邦 🇦🇺
阿鲁巴	阿鲁巴 🇦🇼
奥兰	奥兰 🇦🇽
奥兰群岛	奥兰群岛 🇦🇽
阿赫韦南马	阿赫韦南马 🇦🇽
阿塞拜疆	阿塞拜疆 🇦🇿
阿塞拜疆共和国	阿塞拜疆共和国 🇦🇿
波斯尼亚和黑塞哥维那	波斯尼亚和黑塞哥维那 🇧🇦
波黑	波黑 🇧🇦
巴巴多斯	巴巴多斯 🇧🇧
孟加拉国	孟加拉国 🇧🇩
孟加拉	孟加拉 🇧🇩
比利时	比利时 🇧🇪
比利时王国	比利时王国 🇧🇪
布基纳法索	布基纳法索 🇧🇫
保加利亚	保加利亚 🇧🇬
保加利亚共和国	保加利亚共和国 🇧🇬
巴林	巴林 🇧🇭
巴林王国	巴林王国 🇧🇭
布隆迪	布隆迪 🇧🇮
布隆迪共和国	布隆迪共和国 🇧🇮
贝宁	贝宁 🇧🇯
贝宁共和国	贝宁共和国 🇧🇯
圣巴泰勒米	圣巴泰勒米 🇧🇱
百慕大	百慕大 🇧🇲
文莱	文莱 🇧🇳
文莱达鲁萨兰国	文莱达鲁萨兰国 🇧🇳
玻利维亚	玻利维亚 🇧🇴
玻利维亚国	玻利维亚国 🇧🇴
多民族玻利维亚国	多民族玻利维亚国 🇧🇴
荷属加勒比区	荷属加勒比区 🇧🇶
巴西	巴西 🇧🇷
巴西联邦	巴西联邦 🇧🇷
巴西联邦共和国	巴西联邦共和国 🇧🇷
巴哈马	巴哈马 🇧🇸
巴哈马国	巴哈马国 🇧🇸
不丹	不丹 🇧🇹
不丹王国	不丹王国 🇧🇹
布韦岛	布韦岛 🇧🇻
博茨瓦纳	博茨瓦纳 🇧🇼
博茨瓦纳共和国	博茨瓦纳共和国 🇧🇼
白俄罗斯	白俄罗斯 🇧🇾
白俄	白俄 🇧🇾
伯利兹	伯利兹 🇧🇿
加拿大	加拿大 🇨🇦
科科斯（基林）群岛	科科斯（基林）群岛 🇨🇨
科科斯	科科斯 🇨🇨
刚果（金）	刚果（金） 🇨🇩
刚果	刚果 🇨🇩 🇨🇬
刚果金	刚果金 🇨🇩
中非共和国	中非共和国 🇨🇫
中非	中非 🇨🇫
刚果（布）	刚果（布） 🇨🇬
刚果布	刚果布 🇨🇬
瑞士	瑞士 🇨🇭
瑞士联邦	瑞士联邦 🇨🇭
科特迪瓦	科特迪瓦 🇨🇮
科特迪瓦共和国	科特迪瓦共和国 🇨🇮
库克群岛	库克群岛 🇨🇰
智利	智利 🇨🇱
智利共和国	智利共和国 🇨🇱
喀麦隆	喀麦隆 🇨🇲
喀麦隆共和国	喀麦隆共和国 🇨🇲
中国	中国 🇨🇳
中华人民共和国	中华人民共和国 🇨🇳
五星红旗	五星红旗 🇨🇳
红旗	红旗 🇨🇳
哥伦比亚	哥伦比亚 🇨🇴
哥伦比亚共和国	哥伦比亚共和国 🇨🇴
克利珀顿岛	克利珀顿岛 🇨🇵
哥斯达黎加	哥斯达黎加 🇨🇷
哥斯达黎加共和国	哥斯达黎加共和国 🇨🇷
古巴	古巴 🇨🇺
古巴共和国	古巴共和国 🇨🇺
佛得角	佛得角 🇨🇻
佛得角共和国	佛得角共和国 🇨🇻
库拉索	库拉索 🇨🇼
圣诞岛	圣诞岛 🇨🇽
塞浦路斯	塞浦路斯 🇨🇾
塞浦路斯共和国	塞浦路斯共和国 🇨🇾
捷克	捷克 🇨🇿
捷克共和国	捷克共和国 🇨🇿
德国	德国 🇩🇪
德意志	德意志 🇩🇪
德意志联邦共和国	德意志联邦共和国 🇩🇪
德意志联邦	德意志联邦 🇩🇪
迪戈加西亚岛	迪戈加西亚岛 🇩🇬
吉布提	吉布提 🇩🇯
吉布提共和国	吉布提共和国 🇩🇯
丹麦	丹麦 🇩🇰
多米尼克	多米尼克 🇩🇲
多米尼克国	多米尼克国 🇩🇲
多米尼加共和国	多米尼加共和国 🇩🇴
阿尔及利亚	阿尔及利亚 🇩🇿
阿尔及利亚民主人民共和国	阿尔及利亚民主人民共和国 🇩🇿
休达及梅利利亚	休达及梅利利亚 🇪🇦
休达和梅利利亚	休达和梅利利亚 🇪🇦
休达	休达 🇪🇦
梅利利亚	梅利利亚 🇪🇦
厄瓜多尔	厄瓜多尔 🇪🇨
厄瓜多尔共和国	厄瓜多尔共和国 🇪🇨
爱沙尼亚	爱沙尼亚 🇪🇪
爱沙尼亚共和国	爱沙尼亚共和国 🇪🇪
埃及	埃及 🇪🇬
西撒哈拉	西撒哈拉 🇪🇭
厄立特里亚	厄立特里亚 🇪🇷
厄立特里亚国	厄立特里亚国 🇪🇷
西班牙	西班牙 🇪🇸
西班牙王国	西班牙王国 🇪🇸
埃塞俄比亚	埃塞俄比亚 🇪🇹
埃塞俄比亚联邦民主共和国	埃塞俄比亚联邦民主共和国 🇪🇹
欧盟	欧盟 🇪🇺
欧洲联盟	欧洲联盟 🇪🇺
芬兰	芬兰 🇫🇮
芬兰共和国	芬兰共和国 🇫🇮
斐济	斐济 🇫🇯
斐济共和国	斐济共和国 🇫🇯
福克兰群岛	福克兰群岛 🇫🇰
马尔维纳斯群岛	马尔维纳斯群岛 🇫🇰
密克罗尼西亚	密克罗尼西亚 🇫🇲
法罗群岛	法罗群岛 🇫🇴
法国	法国 🇫🇷
法兰西	法兰西 🇫🇷
法兰西共和国	法兰西共和国 🇫🇷
加蓬	加蓬 🇬🇦
英国	英国 🇬🇧
英伦	英伦 🇬🇧
大不列颠及北爱尔兰联合王国	大不列颠及北爱尔兰联合王国 🇬🇧
格林纳达	格林纳达 🇬🇩
格鲁吉亚	格鲁吉亚 🇬🇪
法属圭亚那	法属圭亚那 🇬🇫
根西岛	根西岛 🇬🇬
加纳	加纳 🇬🇭
加纳共和国	加纳共和国 🇬🇭
直布罗陀	直布罗陀 🇬🇮
格陵兰	格陵兰 🇬🇱
冈比亚	冈比亚 🇬🇲
冈比亚共和国	冈比亚共和国 🇬🇲
几内亚	几内亚 🇬🇳
几内亚共和国	几内亚共和国 🇬🇳
瓜德罗普	瓜德罗普 🇬🇵
赤道几内亚	赤道几内亚 🇬🇶
希腊	希腊 🇬🇷
希腊共和国	希腊共和国 🇬🇷
南乔治亚和南桑威奇群岛	南乔治亚和南桑威奇群岛 🇬🇸
危地马拉	危地马拉 🇬🇹
关岛	关岛 🇬🇺
几内亚比绍	几内亚比绍 🇬🇼
几内亚比绍共和国	几内亚比绍共和国 🇬🇼
圭亚那	圭亚那 🇬🇾
圭亚那合作共和国	圭亚那合作共和国 🇬🇾
中国香港特别行政区	中国香港特别行政区 🇭🇰
中国香港	中国香港 🇭🇰
香港	香港 🇭🇰
香港特别行政区	香港特别行政区 🇭🇰
赫德岛和麦克唐纳群岛	赫德岛和麦克唐纳群岛 🇭🇲
洪都拉斯	洪都拉斯 🇭🇳
洪都拉斯共和国	洪都拉斯共和国 🇭🇳
克罗地亚	克罗地亚 🇭🇷
克罗地亚共和国	克罗地亚共和国 🇭🇷
海地	海地 🇭🇹
海地共和国	海地共和国 🇭🇹
匈牙利	匈牙利 🇭🇺
加纳利群岛	加纳利群岛 🇮🇨
印度尼西亚	印度尼西亚 🇮🇩
印度尼西亚共和国	印度尼西亚共和国 🇮🇩
爱尔兰	爱尔兰 🇮🇪
爱尔兰共和国	爱尔兰共和国 🇮🇪
以色列	以色列 🇮🇱
以色列国	以色列国 🇮🇱
马恩岛	马恩岛 🇮🇲
印度	印度 🇮🇳
印度共和国	印度共和国 🇮🇳
英属印度洋领地	英属印度洋领地 🇮🇴
伊拉克	伊拉克 🇮🇶
伊拉克共和国	伊拉克共和国 🇮🇶
伊朗	伊朗 🇮🇷
伊朗伊斯兰共和国	伊朗伊斯兰共和国 🇮🇷
冰岛	冰岛 🇮🇸
意大利	意大利 🇮🇹
意大利共和国	意大利共和国 🇮🇹
泽西岛	泽西岛 🇯🇪
泽西	泽西 🇯🇪
牙买加	牙买加 🇯🇲
约旦	约旦 🇯🇴
约旦哈希姆王国	约旦哈希姆王国 🇯🇴
日本	日本 🇯🇵
日本国	日本国 🇯🇵
肯尼亚	肯尼亚 🇰🇪
肯尼亚共和国	肯尼亚共和国 🇰🇪
吉尔吉斯斯坦	吉尔吉斯斯坦 🇰🇬
吉尔吉斯共和国	吉尔吉斯共和国 🇰🇬
柬埔寨	柬埔寨 🇰🇭
柬埔寨王国	柬埔寨王国 🇰🇭
基里巴斯	基里巴斯 🇰🇮
基里巴斯共和国	基里巴斯共和国 🇰🇮
科摩罗	科摩罗 🇰🇲
科摩罗联盟	科摩罗联盟 🇰🇲
圣基茨和尼维斯	圣基茨和尼维斯 🇰🇳
朝鲜	朝鲜 🇰🇵
北朝鲜	北朝鲜 🇰🇵
北韩	北韩 🇰🇵
韩国	韩国 🇰🇷
南朝鲜	南朝鲜 🇰🇷
南韩	南韩 🇰🇷
科威特	科威特 🇰🇼
科威特国	科威特国 🇰🇼
开曼群岛	开曼群岛 🇰🇾
哈萨克斯坦	哈萨克斯坦 🇰🇿
哈萨克斯坦共和国	哈萨克斯坦共和国 🇰🇿
老挝	老挝 🇱🇦
老挝人民民主共和国	老挝人民民主共和国 🇱🇦
黎巴嫩	黎巴嫩 🇱🇧
黎巴嫩共和国	黎巴嫩共和国 🇱🇧
圣卢西亚	圣卢西亚 🇱🇨
列支敦士登	列支敦士登 🇱🇮
列支敦士登公国	列支敦士登公国 🇱🇮
斯里兰卡	斯里兰卡 🇱🇰
斯里兰卡民主社会主义共和国	斯里兰卡民主社会主义共和国 🇱🇰
利比里亚	利比里亚 🇱🇷
利比里亚共和国	利比里亚共和国 🇱🇷
莱索托	莱索托 🇱🇸
莱索托王国	莱索托王国 🇱🇸
立陶宛	立陶宛 🇱🇹
立陶宛共和国	立陶宛共和国 🇱🇹
卢森堡	卢森堡 🇱🇺
卢森堡大公国	卢森堡大公国 🇱🇺
拉脱维亚	拉脱维亚 🇱🇻
拉脱维亚共和国	拉脱维亚共和国 🇱🇻
利比亚	利比亚 🇱🇾
利比亚国	利比亚国 🇱🇾
摩洛哥	摩洛哥 🇲🇦
摩洛哥王国	摩洛哥王国 🇲🇦
摩纳哥	摩纳哥 🇲🇨
摩纳哥公国	摩纳哥公国 🇲🇨
摩尔多瓦	摩尔多瓦 🇲🇩
摩尔多瓦共和国	摩尔多瓦共和国 🇲🇩
黑山	黑山 🇲🇪
法属圣马丁	法属圣马丁 🇲🇫
马达加斯加	马达加斯加 🇲🇬
马达加斯加共和国	马达加斯加共和国 🇲🇬
马绍尔群岛	马绍尔群岛 🇲🇭
北马其顿	北马其顿 🇲🇰
北马其顿共和国	北马其顿共和国 🇲🇰
马里	马里 🇲🇱
马里共和国	马里共和国 🇲🇱
缅甸	缅甸 🇲🇲
缅甸联邦	缅甸联邦 🇲🇲
缅甸联邦共和国	缅甸联邦共和国 🇲🇲
蒙古	蒙古 🇲🇳
蒙古国	蒙古国 🇲🇳
中国澳门特别行政区	中国澳门特别行政区 🇲🇴
中国澳门	中国澳门 🇲🇴
澳门	澳门 🇲🇴
澳门特别行政区	澳门特别行政区 🇲🇴
北马里亚纳群岛	北马里亚纳群岛 🇲🇵
马提尼克	马提尼克 🇲🇶
毛里塔尼亚	毛里塔尼亚 🇲🇷
毛里塔尼亚伊斯兰共和国	毛里塔尼亚伊斯兰共和国 🇲🇷
蒙特塞拉特	蒙特塞拉特 🇲🇸
马耳他	马耳他 🇲🇹
马耳他共和国	马耳他共和国 🇲🇹
毛里求斯	毛里求斯 🇲🇺
毛里求斯共和国	毛里求斯共和国 🇲🇺
马尔代夫	马尔代夫 🇲🇻
马尔代夫共和国	马尔代夫共和国 🇲🇻
马拉维	马拉维 🇲🇼
马拉维共和国	马拉维共和国 🇲🇼
墨西哥	墨西哥 🇲🇽
墨西哥合众国	墨西哥合众国 🇲🇽
马来西亚	马来西亚 🇲🇾
莫桑比克	莫桑比克 🇲🇿
莫桑比克共和国	莫桑比克共和国 🇲🇿
纳米比亚	纳米比亚 🇳🇦
纳米比亚共和国	纳米比亚共和国 🇳🇦
新喀里多尼亚	新喀里多尼亚 🇳🇨
尼日尔	尼日尔 🇳🇪
尼日尔共和国	尼日尔共和国 🇳🇪
诺福克岛	诺福克岛 🇳🇫
尼日利亚	尼日利亚 🇳🇬
尼日利亚联邦	尼日利亚联邦 🇳🇬
尼日利亚联邦共和国	尼日利亚联邦共和国 🇳🇬
尼加拉瓜	尼加拉瓜 🇳🇮
尼加拉瓜共和国	尼加拉瓜共和国 🇳🇮
荷兰	荷兰 🇳🇱
尼德兰	尼德兰 🇳🇱
挪威	挪威 🇳🇴
挪威王国	挪威王国 🇳🇴
尼泊尔	尼泊尔 🇳🇵
瑙鲁	瑙鲁 🇳🇷
瑙鲁共和国	瑙鲁共和国 🇳🇷
纽埃	纽埃 🇳🇺
新西兰	新西兰 🇳🇿
阿曼	阿曼 🇴🇲
阿曼苏丹国	阿曼苏丹国 🇴🇲
巴拿马	巴拿马 🇵🇦
巴拿马共和国	巴拿马共和国 🇵🇦
秘鲁	秘鲁 🇵🇪
秘鲁共和国	秘鲁共和国 🇵🇪
法属波利尼西亚	法属波利尼西亚 🇵🇫
巴布亚新几内亚	巴布亚新几内亚 🇵🇬
巴布亚新几内亚独立国	巴布亚新几内亚独立国 🇵🇬
菲律宾	菲律宾 🇵🇭
菲律宾共和国	菲律宾共和国 🇵🇭
巴基斯坦	巴基斯坦 🇵🇰
巴基斯坦伊斯兰共和国	巴基斯坦伊斯兰共和国 🇵🇰
波兰	波兰 🇵🇱
波兰共和国	波兰共和国 🇵🇱
圣皮埃尔和密克隆群岛	圣皮埃尔和密克隆群岛 🇵🇲
皮特凯恩群岛	皮特凯恩群岛 🇵🇳
波多黎各	波多黎各 🇵🇷
巴勒斯坦领土	巴勒斯坦领土 🇵🇸
葡萄牙	葡萄牙 🇵🇹
葡萄牙共和国	葡萄牙共和国 🇵🇹
帕劳	帕劳 🇵🇼
帕劳共和国	帕劳共和国 🇵🇼
巴拉圭	巴拉圭 🇵🇾
巴拉圭共和国	巴拉圭共和国 🇵🇾
卡塔尔	卡塔尔 🇶🇦
卡塔尔国	卡塔尔国 🇶🇦
留尼汪	留尼汪 🇷🇪
罗马尼亚	罗马尼亚 🇷🇴
塞尔维亚	塞尔维亚 🇷🇸
塞尔维亚共和国	塞尔维亚共和国 🇷🇸
俄罗斯	俄罗斯 🇷🇺
俄国	俄国 🇷🇺
俄罗斯联邦	俄罗斯联邦 🇷🇺
卢旺达	卢旺达 🇷🇼
卢旺达共和国	卢旺达共和国 🇷🇼
沙特	沙特 🇸🇦
沙特阿拉伯	沙特阿拉伯 🇸🇦
沙特阿拉伯王国	沙特阿拉伯王国 🇸🇦
所罗门群岛	所罗门群岛 🇸🇧
塞舌尔	塞舌尔 🇸🇨
塞舌尔共和国	塞舌尔共和国 🇸🇨
苏丹	苏丹 🇸🇩
苏丹共和国	苏丹共和国 🇸🇩
瑞典	瑞典 🇸🇪
瑞典王国	瑞典王国 🇸🇪
新加坡	新加坡 🇸🇬
新加坡共和国	新加坡共和国 🇸🇬
圣赫勒拿	圣赫勒拿 🇸🇭
斯洛文尼亚	斯洛文尼亚 🇸🇮
斯洛文尼亚共和国	斯洛文尼亚共和国 🇸🇮
斯瓦尔巴和扬马延	斯瓦尔巴和扬马延 🇸🇯
斯洛伐克	斯洛伐克 🇸🇰
斯洛伐克共和国	斯洛伐克共和国 🇸🇰
塞拉利昂	塞拉利昂 🇸🇱
塞拉利昂共和国	塞拉利昂共和国 🇸🇱
圣马力诺	圣马力诺 🇸🇲
圣马力诺共和国	圣马力诺共和国 🇸🇲
塞内加尔	塞内加尔 🇸🇳
塞内加尔共和国	塞内加尔共和国 🇸🇳
索马里	索马里 🇸🇴
索马里联邦	索马里联邦 🇸🇴
索马里联邦共和国	索马里联邦共和国 🇸🇴
苏里南	苏里南 🇸🇷
苏里南共和国	苏里南共和国 🇸🇷
南苏丹	南苏丹 🇸🇸
南苏丹共和国	南苏丹共和国 🇸🇸
圣多美和普林西比	圣多美和普林西比 🇸🇹
圣多美和普林西比民主共和国	圣多美和普林西比民主共和国 🇸🇹
萨尔瓦多	萨尔瓦多 🇸🇻
萨尔瓦多共和国	萨尔瓦多共和国 🇸🇻
荷属圣马丁	荷属圣马丁 🇸🇽
圣马丁	圣马丁 🇸🇽
叙利亚	叙利亚 🇸🇾
叙利亚共和国	叙利亚共和国 🇸🇾
阿拉伯叙利亚共和国	阿拉伯叙利亚共和国 🇸🇾
斯威士兰	斯威士兰 🇸🇿
斯威士兰王国	斯威士兰王国 🇸🇿
特里斯坦–达库尼亚群岛	特里斯坦–达库尼亚群岛 🇹🇦
特里斯坦–达库尼亚	特里斯坦–达库尼亚 🇹🇦
特克斯和凯科斯群岛	特克斯和凯科斯群岛 🇹🇨
乍得	乍得 🇹🇩
乍得共和国	乍得共和国 🇹🇩
法属南部领地	法属南部领地 🇹🇫
多哥	多哥 🇹🇬
多哥共和国	多哥共和国 🇹🇬
泰国	泰国 🇹🇭
泰王国	泰王国 🇹🇭
暹罗	暹罗 🇹🇭
塔吉克斯坦	塔吉克斯坦 🇹🇯
塔吉克斯坦共和国	塔吉克斯坦共和国 🇹🇯
托克劳	托克劳 🇹🇰
东帝汶	东帝汶 🇹🇱
东帝汶民主共和国	东帝汶民主共和国 🇹🇱
土库曼斯坦	土库曼斯坦 🇹🇲
突尼斯	突尼斯 🇹🇳
突尼斯共和国	突尼斯共和国 🇹🇳
汤加	汤加 🇹🇴
汤加王国	汤加王国 🇹🇴
土耳其	土耳其 🇹🇷
土耳其共和国	土耳其共和国 🇹🇷
特立尼达和多巴哥	特立尼达和多巴哥 🇹🇹
特立尼达和多巴哥共和国	特立尼达和多巴哥共和国 🇹🇹
图瓦卢	图瓦卢 🇹🇻
台湾	台湾 🇹🇼
中华民国	中华民国 🇹🇼
坦桑尼亚	坦桑尼亚 🇹🇿
坦桑尼亚联合共和国	坦桑尼亚联合共和国 🇹🇿
乌克兰	乌克兰 🇺🇦
乌干达	乌干达 🇺🇬
乌干达共和国	乌干达共和国 🇺🇬
美国本土外小岛屿	美国本土外小岛屿 🇺🇲
联合国	联合国 🇺🇳
美国	美国 🇺🇸
美利坚	美利坚 🇺🇸
美利坚合众国	美利坚合众国 🇺🇸
星条旗	星条旗 🇺🇸
乌拉圭	乌拉圭 🇺🇾
乌拉圭东岸共和国	乌拉圭东岸共和国 🇺🇾
乌兹别克斯坦	乌兹别克斯坦 🇺🇿
乌兹别克斯坦共和国	乌兹别克斯坦共和国 🇺🇿
梵蒂冈	梵蒂冈 🇻🇦
梵蒂冈城国	梵蒂冈城国 🇻🇦
圣文森特和格林纳丁斯	圣文森特和格林纳丁斯 🇻🇨
委内瑞拉	委内瑞拉 🇻🇪
委内瑞拉玻利瓦尔共和国	委内瑞拉玻利瓦尔共和国 🇻🇪
英属维尔京群岛	英属维尔京群岛 🇻🇬
美属维尔京群岛	美属维尔京群岛 🇻🇮
越南	越南 🇻🇳
越南社会主义共和国	越南社会主义共和国 🇻🇳
瓦努阿图	瓦努阿图 🇻🇺
瓦努阿图共和国	瓦努阿图共和国 🇻🇺
瓦利斯和富图纳	瓦利斯和富图纳 🇼🇫
萨摩亚	萨摩亚 🇼🇸
萨摩亚独立国	萨摩亚独立国 🇼🇸
科索沃	科索沃 🇽🇰
科索沃共和国	科索沃共和国 🇽🇰
也门	也门 🇾🇪
也门共和国	也门共和国 🇾🇪
马约特	马约特 🇾🇹
南非	南非 🇿🇦
南非共和国	南非共和国 🇿🇦
赞比亚	赞比亚 🇿🇲
赞比亚共和国	赞比亚共和国 🇿🇲
津巴布韦	津巴布韦 🇿🇼
津巴布韦共和国	津巴布韦共和国 🇿🇼
英格兰	英格兰 🏴󠁧󠁢󠁥󠁮󠁧󠁿
苏格兰	苏格兰 🏴󠁧󠁢󠁳󠁣󠁴󠁿
威尔士	威尔士 🏴󠁧󠁢󠁷󠁬󠁳󠁿
